#front|back
的|[de] {grammatical particle marking genitive as well as simple and composed adjectives}>; 我的 wǒde my; 高的 gāode high, tall; 是的 shìde that's it, that's right; 是...的 shì...de one who...; 他是说汉语的. Tā shì shuō Hànyǔde. He is one who speaks Chinese.<br /><br /><br /><br />[dì] 目的 mùdì goal<br /><br /><br /><br />[dí] true, real; 的确 díquè certainly
一(A壹)|[yī] one, a little; 第一 dì-yī first, primary; 看一看 kànyīkàn have a (quick) look at<br /><br /><br /><br />[yí] (used before tone #4); 一个人 yí gè rén one person; 一定 yídìng certain; 一样 yíyàng same; 一月yíyuè January<br /><br /><br /><br />[yì] (used before tones #2 and #3); 一点儿 yìdiǎnr a little; 一些 yìxiē some<br /><br /><br /><br />{Compare with 幺(F么) yāo, which also means "one"}
是|[shì] to be, 是不是? shìbushì? is (it) or is (it) not?; 是否 shìfǒu whether or not, is (it) or is (it) not?
不|[bù] not<br /><br /><br /><br />[bú] (used before tone #4); 不是 bú shì isn't
了|[le] {verb particle marking a new situation or a completed action}>; 你来了! Nǐ láile! You have come! 我累了! Wǒ lèile! I've gotten tired! 那好了! Nà hǎole! That's OK (now)! 我只请了一位客人. Wǒ zhǐ qǐngle yí wèi kèren. I invited only one guest.<br /><br /><br /><br />[liǎo] end, finish, settle, dispose of, know clearly, to be able, (=了解 liǎojiě) understand, comprehend; 了了 liǎoliaǒ clearly understand, settle (a debt/etc.), to be intelligent; 了了 liǎole {colloquial}> to be over/ended/finnish/settled; 你卖不了! Nǐ mài bùliǎo! You will not be able to sell (it)!<br /><br /><br /><br />[liào] (=瞭 liaò) to survey/watch<br /><br /><br /><br />{Compare with 子 zǐ child}{/colloquial}>
人|[rén] person; 人类 rénlèi humankind; 有人吗? yǒu rén ma? Is there anybody here?<br /><br /><br /><br />{Compare with 入 rù enter}
我|[wǒ] I, me, my; 我们 wǒmen we, us<br /><br /><br /><br />{Compare with 找 zhǎo seek}
在|[zài] at; 现在 xiànzài now; 存在 cúnzài exist
有|[yǒu] have, there is; 没有 méiyǒu haven't, there isn't; 有没有? Yǒuméiyǒu? Is there or isn't there? Have (you) or haven't (you)?; 有的 yǒude some<br /><br /><br /><br />[yòu] (=又 yòu) again, both... and...
他|[tā] he, him, his, (she, her, it, its), (=其他 qítā) other<br /><br />[tuō] (in classical texts) someone else, something else
這|[zhè] this; 这儿 zhèr here<br /><br />[zhèi] this (before classifier)
中|[zhōng] middle, in; 中国 Zhōngguó China<br /><br />[zhòng] hit (a target)
大|[dà] big; 多大? duōdà? how large?; 大小 dàxiǎo size; 大家 dàjiā everybody<br /><br />[dài] 大夫 dàifu doctor<br /><br />{Compare with 太 tài very and 木 mù tree}
來|[lái] come; 原来 yuánlái originally, as a matter of fact; 来年 láinián coming/next year(s)<br /><br />[lai] (when used as a verb complement); 起来 qǐlai get up
上|[shàng] above, on, over, top, (go) up, last, previous<br /><br />[shǎng] 上声 shǎngshēng 3rd tone in Mandarin<br /><br />[shang] (when used as a verb complement)<br /><br />{Compare with 下 xià under}
國|[guó] (=国家 guójiā) country, state, nation, {family name}>; 中国 Zhōngguó China; 美国 Měiguó USA
個,箇|[gè] {general and non-specific classifier}>; 个人 gèrén personal; 个人主页 gèrénzhùyè personal homepage<br /><br />[gě] 自个 zìgě oneself
到|[dào] to, towards, until, arrive, reach
說|[shuō] explain, scold, refer to, (=说话 shuōhuà) speak, say; 游说 yóushuō persuade<br /><br />[shuì] try to persuade; 游说 yóushuì lobbying
們|[men] {pluralizing suffix for pronouns and nouns referring to persons}>; 我们 wǒmen we; 人们 rénmen people, persons
為|[wèi] for, for the sake of, in order to, in this connection<br /><br />[wéi] do, act, act as, be, become; 认为 rènwéi think or believe that...; 以为 yǐwéi think or believe erroneously that...<br /><br />{Compare with 办 bàn do}
子|[zǐ] child, son; 子女 zǐnǚ sons and daughters; 儿子 érzi son<br /><br />[zi] (noun suffix); 桌子 zhuōzi table<br /><br />{Compare with 了 le {particle}>}
和|[hé] together, with, (F龢) harmony, gentle, mild, kind, {family name}>; 和平 hépíng peace<br /><br />[Hé] Japan<br /><br />[huo] 暖和 nuǎnhuo nice and warm<br /><br />[hè] join in singing, compose a poem in reply<br /><br />[huó] mix with water<br /><br />[huò] mix, blend<br /><br />[hú] complete a set in Mahjong
你|[nǐ] (Alternative feminine form: 妳 nǐ) you, your; 你们 nǐmen you (plural)
地|[dì] earth, ground, soil, place, position, distance; 地支 dìzhī the Twelve Terrestrial Branches<br /><br />[de] {adverbial particle: descripion + 地 + verb}>, ~ly; 快地走 kuàide zǒu walk quickly
出|[chū] go out, come out, in direction out from something, emit, issue, prouce; 出现 chūxiàn appear, emerge, (F齣) {classifier for operas and plays}>
道|[dào] way, path, channel, way, say, a streak (of light), doctrine, {classifier for rivers, topics, etc.}>, (=道教 Dàojiào) Taoism; 知道 zhīdao know<br /><br />[dǎo] (=导 dǎo) lead; 领道 = 领导 lǐngdǎo leader
也|[yě] also, as well; 也许 yěxǔ perhaps
時|[shí] period, season, (=时间 shíjiān, =时候 shíhou) time, (=小时 xiǎoshí) hour
年|[nián] year, {family name}>; 今年 jīnnián this year; 明年 míngnián next year; 去年 qùnián last year; 中年 zhōngnián middle age
得|[de] {adverbial particle: verb + 得 + descripion}>; 走得快 zǒude kuài walk quickly<br /><br />[dé] get, reach, achieve<br /><br />[děi] should
就|[jiù] just, simply, right away; 就要 jiùyào about to (do something); 这就是我! Zhè jiùshì wǒ! This is simply me!; 他就要去. Tā jiùyào qù. He is about to leave.
那|[nà] that<br /><br />[nèi] that (before classifier)<br /><br />[nuó] 禅那 chánnuó deep meditation<br /><br />[nuò] 无那 wúnuò helpless, unfortunately<br /><br />[nǎ] (=哪 nǎ) what?<br /><br />[něi] (=哪 něi before classifier) which?
要|[yào] want, will, shall, need, important, essential; 主要 zhǔyào main, fundamental<br /><br />[yāo] 要求 yāoqiú demand
下|[xià] below, under, (go) down, next (as opposed to previous/last)<br /><br />{Compare with 上 shàng above}
以|[yǐ] use, take, according to, because of, in order to; 可以 kěyǐ OK, may; 所以 suǒyǐ so, therefore, as a result; 以外 yǐwài beyond, except
生|[shēng] give birth, life; 先生 xiānsheng mister, gentleman, Sir
會|[huì] can, able, meet, meeting, society, union, party<br /><br />[kuài] 会计 kuàijì accounting<br /><br />[huǐ] 会儿 huìr moment
自|[zì] from, since, (=自己 zìjǐ) self; 自然 zìrán nature<br /><br />{Compare with 目 mù eye and 白 bái white}
著|[zhe] {verb particle marking a continuing progress/state}><br /><br />[zháo] touch<br /><br />[zhuó] wear clothes, dress, touch<br /><br />[zhāo] put in, add, (F招) make move in chess, trick, decieve<br /><br />[zhù] write, book<br /><br />[zhe] (S着)<br /><br />[zháo] (S着)<br /><br />[zhuó] (S着)<br /><br />[zhāo] (S着)
去|[qù] go, leave, depart (opposite of 来 lái)
之|[zhī] {subordinator similar to 的 de}>, it (in classical texts)
過|[guò] pass, cross, go by, exceed, {verb particle marking that someone has had the experience of doing something, that it has happened at least once}>; 过马路 guò mǎlù cross the street; 我去过中国两次. wǒ qùguo Zhōngguó liǎng cì. I have gone to China twice.
家|[jiā] home, house, family; 国家 guójiā nation; 大家 dàjiā everybody<br /><br />[jie] 整天家 zhěngtiānjie all day long; 家里 jiālǐ (at) home, (in the) family
學|[xué] study, learn; 学校 xuéxiào school; 学生 xuésheng student<br /><br />{Compare with 字 zì written character}
對|[duì] correct, answer, treat, agree, mutual, pair; 对不起 duìbuqǐ excuse me
可|[kě] ~able, (=可以 kěyǐ) may, can, (=可是 kěshì) but, however; 可爱 kě'ài loveable, cute; 可能 kě'néng possible, probable, maybe; 可口可乐 kěkǒukělè Coca Cola<br /><br />[kè] 可汗 kèhán khan
她|[tā] she, her
里|[lǐ] neighbourhood, half kilometer, {family name}>, (F裏,裡) in, inside, lining; 哪里? nǎli? where?; 那里 nàli there; 这里 zhèli here
后|[hòu] queen, (F後) after, behind, {family name}>; 后天 hòutiān the day after tomorrow
小|[xiǎo] small; 大小 dàxiǎo size
么|[me/mo] (F麼,末) (interrogative suffix) 什么? shénme? what?; 为什么? wèishénme? why? 没什么! méi shénme! It doesn't matter!, Never mind!; 怎么? zěnme? how?<br /><br />[yāo] (S幺) youngest, one (e.g. in bus/house/phone numbers)
心|[xīn] heart; 小心 xiǎoxīn be careful; 心理 xīnlǐ psychology, mentality; 中心 zhōngxīn center
多|[duō] many, much, more; 多大 duōdà how large?; 多少 duōshǎo how many/much?
天|[tiān] sky, heaven, god, day, (=天空 tiānkōng) sky; 天气 tiānqì weather<br /><br />{天干 tiāngān the Ten Heavenly Stems: 甲乙丙丁戊己庚辛壬癸 jiǎ-yǐ-bǐng-dīng-wù-jǐ-gēng-xīn-rén-guǐ (these characters are sometimes used as ordinal numbers}<br /><br />{Compare with 夫 fū man and 无 wú without}
而|[ér] (=而且 érqiě) and, furthermore, (=然而 rán'ér) yet, even so
能|[néng] can, be able; 能够 nénggòu be capable of; 可能 kě'néng maybe
好|[hǎo] good, good to..., easy to...; 你好! Nǐhǎo! Hello!<br /><br />[hào] to like<br /><br />[hāo] 好好儿 hǎohāor in perfectly good condition
都|[dōu] all<br /><br />[dū] (=首都 shǒudū) capital city
然|[rán] right, correct, so, like that; 虽然 suīrán although; 忽然 hūrán suddenly; 当然 dāngrán of course; 自然 zìrán nature
沒|[méi] (=没有 méiyǒu) haven't, there isn't; 有没有? Yǒuméiyǒu? Is there or isn't there? Have (you) or haven't (you)?<br /><br />[mò] sink, overflow, disappear, confiscate
日|[rì] sun, (=日子 rìzi) day; 日记 rìjì diary; 日光 rìguāng sunlight<br /><br />{Compare with 曰 yuē say, 目 mù eye and 甘 gān sweet}
于|[yú] {family name}>, (F於) in, at, for, to, from, by, than<br /><br />{Compare with 千 qiān thousand and 干 gān stem}
起|[qǐ] rise, start; 起来 qǐlai get up; 对不起 duìbuqǐ excuse me<br /><br />[qi] (when used as a verb complement)
還|[hái] still, yet<br /><br />[huán] return, give back
发|[fā] (F發) deliver, utter, express, shoot, emit, develop, expand<br /><br />[fà] (F髮) hair<br /><br />[fa] (F髮) 头发 tóufa hair
成|[chéng] (=成为 chéngwéi, =变成 biànchéng) become, {family name}>; 成功 chénggōng succeed; 完成 wánchéng accomplish, complete, fulfill; 成语 chéngyǔ idiom
事|[shì] matter, affair, thing, event, accident, job, responsibility; 事情 shìqing situation
祇|[zhǐ] only, just, merely, {classifier implying "one of a pair", animals, vessels, utensils, etc.}>; 一只猫 yì zhǐ māo a cat<br /><br />[zhī] (F隻) single, one, only<br /><br />{Compare with 兄 xiōng brother}
作|[zuò] do, make; 工作 gōngzuò work; 作业 zuòyè homework<br /><br />[zuó] 作践 zuójian spoil, waste, humiliate, insult<br /><br />[zuō] do
当|[dāng] (F當) serve as, (F噹) ding-dong<br /><br />[dàng] (F當) proper, right, equal, (=当作 dàngzuò) treat as, regard as
想|[xiǎng] think, feel, consider, want, remember
看|[kàn] see, look at, read, think, consider<br /><br />[kān] look after, tend; 看守 kānshǒu guard
文|[wén] language, literature, {family name}>; 文化 wénhuà culture; 中文 Zhōngwén Chinese (written) language
無|[wú] without, nothingness, have not<br /><br />[mó] 南无 nánmó {Sanskrit}> to give oneself totally to<br /><br />{Compare with 天 tiān heaven}
開|[kāi] open; 开始 kāishǐ begin 打开 dǎkāi open, unfold<br /><br />[kai] (when used as a verb complement)<br /><br />{Compare with 并 bìng combine}
手|[shǒu] hand, a person skilled in something; 挥手 huīshǒu wave; 拍手 pāishǒu clap; 握手 wòshǒu shake/clasp hands<br /><br />{Compare with 毛 máo hair}
十(A拾)|[shí] ten; 十三 shísān thirteen; 五十 wǔshí fifty; 十月 shíyuè October
用|[yòng] use; 好用 hǎoyòng useful; 不用 búyòng there's no need; 使用 shǐyòng use, apply<br /><br />{Compare with 甩 shuǎi swing}
主|[zhǔ] lord, master, host, god, (=主要 zhǔyào) main, primary; 主义 zhǔyì doctrine, ~ism; 主页 zhùyè homepage<br /><br />{Compare with 王 wáng king}
行|[xíng] go, OK; 行动 xíngdòng action, operation, move, get about, act<br /><br />[háng] line; 银行 yínháng bank; 行业 hángyè profession<br /><br />[hàng] 树行子 shùhàngzi rows of trees<br /><br />[héng] (phonetic radical)
方|[fāng] side, square; 地方 dìfang place; 方面 fāngmiàn aspect<br /><br />{Compare with 万 wàn ten thousand}
又|[yòu] again, both... and...
如|[rú] like, as, as if, (=如果 rúguǒ) if; 如此 rúcǐ like this
前|[qián] in front, previous, ago, former, first; 前天 the day before yesterday
所|[suǒ] place; 所以 suǒyǐ so, therefore; 所有 suǒyǒu all; 厕所 cèsuǒ toilet
本|[běn] basis, origin, edition, {classifier for books, periodicals, files, etc.}>; 本人 běnrén I, me, myself; 日本 Rìběn Japan<br /><br />{Compare with 木 mù tree}
見|[jiàn] appear to be, meet with, call on, (=看见 kànjian) see; 意见 yìjian idea, view, opinion; 听见 tīngjiàn hear<br /><br />[xiàn] show, appear, become visible<br /><br />{Compare with 贝 bèi shellfish}
經|[jīng] longitude (both geographic and in Chinese medecin), scripture, constant, regular, {family name}>, deal with, (=经纪 jīngjì) manage (a business); 已经 yǐjing already; 经过 jīngguò pass, go through; 经验 jīngyàn experience; 经由 jīngyóu via, by way of; 经常 jīngcháng frequent, daily; 易经 Yìjīng Book of Changes;
頭|[tóu] head, top, first, {classifier for livestock, garlic, etc.}>; 头发 tóufa hair<br /><br />[tou] 石头 shítou stone
面|[miàn] face, surface, {classifier for mirrors, flags, etc.}>, (F麵) wheat flour, (=面条 miàntiáo) noodle; 面包 miànbāo bread
公|[gōng] public, official; 公里 gōnglǐ kilometer; 办公室 bàngōngshì office; 公司 gōngsī company; 公共 gōnggòng public, communal, common; 公共汽车 gōnggòngqìchē (public) bus; 李公 Lǐgōng (honorable and old) Mr Li
同|[tóng] same, with; 同志 tóngzhì comrade<br /><br />[tòng] (F衕) 胡同 hútòng lane
三(A叁)|[sān] three; 第三世界 dì-sān shìjiè 3rd World; 三月 sānyuè March
已|[yǐ] stop, cease, end, (=已经 yǐjīng) already<br /><br />{Compare with 己 jǐ self, which is "open" on the left side}
老|[lǎo] old, venerable, outdated; 老师 lǎoshī teacher; 老虎 lǎohǔ tiger; 老张 lǎo Zhāng old Zhang = dear (friend) Mr Zhang
從|[cóng] from, through, join, follower, secondary<br /><br />[cōng] 黑从从 hēicōngcōng murky
動|[dòng] move, change, arouce; 动物 dòngwù animal; 活动 huódòng activity; 运动 yùndòng sports
兩|[liǎng] two (before classifier), 50 grams
長|[cháng] long, lasting, length<br /><br />[zhǎng] grow up, chief, head, older, elder
知|[zhī] realize, sense, inform, tell, (=知道 zhīdao) know; 知识 zhīshi knowledge<br /><br />[zhì] (=智 zhì) wit, (=智慧 zhìhuì) wisdom, (=智力 zhìlì) intellect
民|[mín] (=人民 rénmín) people, {family name}>; 民主 mǐnzhǔ democracy
樣|[yàng] appearance, shape, form, manner; 这样 zhèyàng like this; 怎么样 zěnmeyàng how? in what way?
現|[xiàn] show, appear, current; 现在 xiànzài now; 发现 fāxiàn discover; 现代 xiàndài modern
分|[fēn] divide, fraction, minute, cent; 百分之五 bǎifēnzhīwǔ = 5/100 = 5%<br /><br />[fèn] limits of rights or duty
將|[jiāng] shall; 将来 jiānglái future<br /><br />[jiàng] general, a piece in Chinese chess 麻将 májiàng mahjongg
外|[wài] outside, outer, other, foreign, beyond, relative on ones mother's/sisters/wife's side; 外孙 wàisūn daugthers son; 外国人 wàiguórén foreigner; 意外 yìwài unexpected<br /><br />{Compare with 处 chù place}
但|[dàn] (=但是 dànshì) but, still, nevertheless, however, yet
身|[shēn] life, incarnation, {classifier for suits of clothing}>, (=身体 shēntǐ) body; 亲身 qīnshēn in person, personally
些|[xiē] some, {classifier for plural or indefinite/small amount}>; 一些 yìxiē a number of, some; 这些人 zhèxiē rén these people
與|[yǔ] give, offer, help, support, and<br /><br />[yù] 参与 cānyù participate in<br /><br />[yú] 欤 {interrogative/esclamative particle}><br /><br />{Compare with 写 xiě write}
高|[gāo] high, tall, loud, {polite}> your, {family name}>; 提高 tígāo improve; 高兴 gāoxìng happy; 高见 gāojiàn {polite}> your opinion/idea
意|[yì] (=意思 yìsi, =意义 yìyì) meaning, idea, (=愿意 yuànyi) wish, desire; 意图 yìtú intention; 意见 yìjian opinion; 意大利 Yìdàlì Italy
進|[jìn] enter, go forward, recieve, drink, eat, submit; 进步 jìnbù progress
把|[bǎ] grasp, hold, handle, {classifier for things with handles, handfuls, chairs, etc.}><br /><br />[bà] 把子 bàzi, 把儿 bàr handle
法|[fǎ] (=法律 fǎlǜ) law, (=办法 bànfǎ) method; 法国 Fǎguó France
此|[cǐ] this; 如此 rúcǐ (=这样 zhèyàng) like this; 此地 cǐdì (=这里 zhèlǐ) here, at this place
實|[shí] solid, true, real; 事实 shìshí fact; 实际上 shíjìshang actually; 实在 shízài really
回|[huí] circle, return, reply, turns, times, chapter, Muslim, Hui (ethnic minority), {classifier for chapters, times, etc.}>; 回来 huílái come back; 回去 huíqù go back; 回答 huídá answer
二(A贰)|[èr] two; 二月 èryuè February
理|[lǐ] principle; 理论 lǐlùn theory; 管理 guǎnlǐ manage; 心理 xīnlǐ psychology, mentality
美|[měi] (=美丽 meilì) beautiful, (=好 hǎo) good, (=美德 měidé) virtue, {family name}>; 美国 Měiguó USA; 美元 měiyuán US$ 美家 měijiā artist
點|[diǎn] a drop (of liquid), dot, decimal point, a little, a bit, appoint time, select, choose, order food/drink, {classifier for small amounts}>, (=点火 diǎnhuǒ) light a fire; 一点儿 yìdiǎnr a little; 点头 diǎntóu nod one's head
月|[yuè] month, (=月亮 yuèliang, =月球 yuèqiú) moon
明|[míng] bright, clear, distinct, next (day or year), {family name}>; 明白 míngbai clear, understand; 明天 míngtiān tomorrow
其|[qí] its, that, such, they, them; 其他 qítā other; 尤其 yóuqí especially<br /><br />[jī] anniversary
種|[zhǒng] kind, sort, breed, race<br /><br />[zhòng] to plant, cultivate
聲|[shēng] voice, declaration, (=声音 shēngyīn) sound, {classifier for sounds}>; 声名 shēngmíng reputation, fame, statement, declaration
全|[quán] whole, entire, total, complete, {family name}>; 完全 wánquán completely; 安全 ānquán safety
工|[gōng] (=工作 gōngzuò) work, job; 工人 gōngrén worker
己|[jǐ] (=自己 zìjǐ) self<br /><br />{Compare with 已 yǐ already, which is "closed" on the left side}
話|[huà] speech, word, language, dialect, (=说话 shuōhuà) talk, speak<br /><br />[huo] 白话 báihuo = báihuà vernacular, empty talk
兒|[ér] child; 儿子 érzi son; 女儿 nǚ'ér daughter<br /><br />[r] (noun suffix); 这儿 zhèr here; 那儿 nàr there<br /><br />[rén] (when referring to the radical)<br /><br />{Compare with 兄 xiōng brother, 几 jǐ table, 臾 yú moment}
者|[zhě] one who...; 作者 zuòzhě author; 和平主义者 hépíngzhǔyìzhě pacifist
向|[xiàng] take somebody's part, to, towards, all along, allways, {family name}>, (F嚮) direction, towards, (F曏) formerly, previously; 向者 xiàngzhě formerly, once upon a time
情|[qíng] sensibility, (=感情 gǎnqíng) feeling, emotion; 爱情 àiqíng love
部|[bù] (=部分 bùfen) part, section, unit, {classifier for film, large books, machines, etc.}>, (=部队 bùduì) troops, army; 西部 xībù western part; 全部 quánbù entire
正|[zhèng] right, straight, upright, correct<br /><br />[zhēng] 正月 zhēngyuè, 新正 xīnzhēng the 1st month of lunar year
名|[míng] (=名字 míngzi) name, personal name, reputation, famous, {classifier for persons with professional or prominent social identities, e.g. students, doctors, soldiers, workers}>; 著名 zhùmíng famous; 名词 míngcí noun
定|[dìng] fix, settle, calm, stable, subscribe, (=决定 juédìng) decide; 一定 yídìng definite
女|[nǚ] female, (=女人 nǚrén, =妇女 fùnǚ) woman
問|[wèn] ask, examine; 问题 wèntí question, problem; 访问 fǎngwèn visit
力|[lì] (=活力 nénglì) energy, vitality, {family name}>, (=力量 lìliang) strength, force
機|[jī] (=机器 jīqi) machine; 收音机 shōuyīnjī radio; 飞机 fēijī aircraft
給|[gěi] give, give to, for, for the benefit of; 送给 sònggěi send/present to<br /><br />[jǐ] give, supply, provide, (=供给 gōngjǐ) provide
等|[děng] equal, class, wait, and so on, etc.
几|[jī] small table, (F幾) 几乎 jīhū almost<br /><br />[jǐ] (F幾) how many?, a few, (used in numerals)<br /><br />{Compare with 儿 ér child}
很|[hěn] very, quite; 很好 hěnhǎo very good; 很不错! hěn búcuò! not bad at all!
業|[yè] line of business, trade, occupation, profession, course of study, engage in, {family name}>; 商业 shāngyè commerce; 工业 gōngyè industry; 作业 zuòyè homework
最|[zuì] most, marking for superlative; 最近 zuìjìn recently/soon; 最喜欢 zuì xǐhuan favorite
間|[jiān] room, between, locality, within given time or space, {classifier for rooms}><br /><br />[jiàn] gap, interval<br /><br />[gān] 半间不界 bàn'gānbùgà neither this nor that, inexplicit, equivocal, mediocre
新|[xīn] new, renew; 重新 chóngxīn again; 新闻 xīnwén news
甚|[shén] 什么 shénme what?<br /><br />[shí] (=十 shí) ten<br /><br />[shèn] very; 甚至 shènzhì even, go so far as to<br /><br />[shén] (=什 shén) what?; 甚么 = 什么 shénme what?
打|[dǎ] strike, hit, get, play, (generalized verb with specific meaning determined by its object); 打算 dǎsuan plan, intend; 打开 dǎkāi open, unfold; 打击 dǎjī strike, hitt, attack, assault<br /><br />[dá] dozen
便|[biàn] (=方便 fāngbiàn) convenient<br /><br />[pián] 便宜 piányi cheap<br /><br />{Compare with 使 shǐ send and 更 gèng more}
位|[wèi] place, location, position, {polite classifier for people}>
因|[yīn] cause, (=因为 yīnwèi) because, (=原因 yuányīn) reason
重|[zhòng] weight, considerable in amount/value, (=沉重 chénzhòng) heavy, weighty, (=重要 zhòngyào) important<br /><br />[chóng] again
被|[bèi] quilt, cover (with), by (indicates passive voice)<br /><br />[pī] 被服 pīfú = bèifú bedding and clothing, something one hangs on to
走|[zǒu] go, walk, leave
電|[diàn] (=闪电 shǎndiàn) (flash of) lightning, (=电气 diànqì) electricity; 电话 diànhuà phone; 电脑 diànnǎo computer
四(A肆)|[sì] four; 四周 sìzhōu all around; 四月 sìyuè April
第|[dì] indicating ordinal number, ~th; 第三世界 dì-sān shìjiè 3rd World; 第一次 dì-yī cì 1st time
門|[mén] door, gate, family, house, valve, switch, {family name}>, {classifier for courses, braches of science, etc.}>; 门口 ménkǒu doorway; 部门 bùmén department; 门铃 ménlíng doorbell
相|[xiāng] each other, mutual, mode, phase, {family name}><br /><br />[xiàng] look at, appearance, photo
次|[cì] occurence, time, second, inferior, number of times; 两次 liǎng cì twice
東|[dōng] master, owner, {family name}> (=东方 dōngfāng) east; 东北 dōngběi northeast; 东西 dōngxi thing, creature<br /><br />{Compare with 车 chē vehicle}
政|[zhèng] (=政治 zhèngzhì) politics, political affairs, (=政府 zhèngfǔ) government
海|[hǎi] sea, big lake, {family name}>, (=海洋 hǎiyáng, =大海 dàhǎi) sea, ocean
口|[kǒu] mouth, opening, entrance, hole, cut, {classifier for mouthfuls, people, wells, etc.}>; 门口 ménkǒu doorway; 人口 rénkǒu population
使|[shǐ] make, cause to (do), send (as envoy), (=使用 shǐyòng) use, apply<br /><br />{Compare with 吏 lì and 便 biàn official}
教|[jiāo] teach; 王老师教数学. Wáng lǎoshī jiāo shùxué. Teacher Wang teaches math.<br /><br />[jiào] cause, ask to, teach; 教师 jiàoshī teacher, instructor; 教育 jiàoyù education
西|[xī] west, western; 东西 dōngxi thing; 西北 xīběi northwest
再|[zài] again, once more; 再见 zàijiàn goodbye
平|[píng] flat, level, even; 水平 shuǐpíng level; 和平 hépíng peace; 平常 píngcháng ordinary, common, usually<br /><br />{Compare with 半 bàn half}
真|[zhēn] true, genuine, really<br /><br />{There are two ways of writing this character!}
聽|[tīng] listen; 听见 tīngjiàn hear; 听不懂 tīngbudǒng don't understand (by listening)
世|[shì] generation, {family name}>, (=世界 shìjiè) world; 世纪 shìjì century
氣|[qì] air, gas, vapor, spirit, vital energy; 天气 tiānqi weather
信|[xìn] letter, message, information, (=相信 xiāngxìn) belive in; 信封 xìnfēng envelope
北|[běi] north; 东北 dōngběi northeast; 北京 Běijīng
少|[shǎo] few, little, less, lack<br /><br />[shào] young; 少年 shàonián juvenile
關|[guān] shut, close, turn off, close down, concern, key part; 关系 guānxi connection; 关于 guānyú concerning
并|[bìng] (F併) combine, merge, (F並) and, equally, truly<br /><br />[bīng] 并州 Bìng Zhōu (Taiyuan in Shanxi)<br /><br />{Compare with 开 kāi open}
內|[nèi] inside; 内容 nèiróng content<br /><br />{Compare with 肉 ròu meat and 丙 bǐng third}
加|[jiā] add, plus, append, (=增加 zēngjiā) increase; 参加 cānjiā join
化|[huà] convert, melt, dissolve, digest, incinerate, (=变化 biànhuà) change, transform<br /><br />[huā] (=花 huā) spend
由|[yóu] from, let, (=由于 yóuyú) due to, (=理由 lǐyóu) cause, reason; 自由 zìyóu freedom<br /><br />{Compare with 甲 jiǎ helmet and 申 shēn explain}
卻|[què] however, but, yet
代|[dài] (=代表 dàibiǎo) represent, (=时代 shídài) generation, period, epoch, {classifier for periods}>; 现代 xiàndài modern (times); 上代 shàngdài previous generation
軍|[jūn] army, military, troops
產|[chǎn] give birth to, (=产生 chǎnshēng) produce, (=产品 chǎnpǐn) product
入|[rù] (=进入 jìnrù) enter, get into; 收入 shōurù income<br /><br />{Compare with 人 rén person}
先|[xiān] first, before, earlier; 先生 xiānsheng mister, gentleman, Sir; 祖先 zǔxiān = 先辈 xiānbèi ancestor<br /><br />{Compare with 失 shī lose}
山|[shān] hill, mountain, {family name}>; 火山 huǒshān volcano; 山脉 shānmài mountain range
五(A伍)|[wǔ] five; 五月 wǔyuè May
太|[tài] great, very, too; 太太 tàitai Madame; 太阳 tàiyáng sun, sunshine<br /><br />{Compare with 大 dà big}
水|[shuǐ] water, liquid, {family name}>; 水平 shuǐpíng level; 水果 shuǐguǒ fruit; 药水 yàoshuǐ liquid medecine<br /><br />{Compare with 永 yǒng forever}
萬|[wàn] ten thousand, myriad, {family name}>; 万岁 wànsuì long live<br /><br />[Mò] 万俟 Mòqí {family name}><br /><br />{Compare with 方 fāng square}
市|[shì] (=市场 shìchǎng) market, (=城市 chéngshì) city, town
眼|[yǎn] (=眼睛 yǎnjing) eye; 眼镜 yǎnjìng glasses
體|[tǐ] substance, (=身体 shēntǐ) body; 具体 jùtǐ concrete, specific; 体字 tǐzì style of written Chinese, typface, font<br /><br />[tī] 体己 tīji (or tǐjǐ) intimate, confidential
別,彆|[bié] separate, other, don't, leave, differentiate, {family name}><br /><br />[biè] 别扭 bièniu awkward
處|[chù] place, part, point, department, office<br /><br />[chǔ] deal with, get along with somebody<br /><br />{Compare with 外 wài outside}
總|[zǒng] general, overall, always, (=总数 zǒngshù) sum, total; 总统 zǒngtǒng president (of a republic)
纔|[cái] talent, only then; 刚才 gāngcái just now
場|[chǎng] field, place where people gather, stage, level open ground, country fair, market, {classifier for games, performances etc.}><br /><br />[cháng] {classifier for happenings}>
師|[shī] (=老师 lǎoshī) teacher; 师傅 shīfu master
書|[shū] book, style of calligraphy; 书记 shūji clerk; 图书馆 túshūguǎn library
比|[bǐ] compare, contrast; 比较 bǐjiào relatively; 比如 bǐrú efor example
住|[zhù] live (in a place)
員|[yuán] member. ~ist, ~er; 委员会 wěiyuánhuì committee; 人员 rényuán personnel
九(A玖)|[jiǔ] nine; 九月 jiǔyuè September
笑|[xiào] laugh
性|[xìng] sex, gender, nature, disposission, ~ness; 可能性 kěnéngxìng possibility
通|[tōng] communicate, notify, connect, join, know very well, authority, expert, (=通过 tōngguò) go through, {classifier for telegrams}>, {family name}>; 交通 jiāotōng traffic; 普通话 Pǔtōnghù Common Speach = Mandarin<br /><br />[tòng] {classifier for actions}>
目|[mù] eye; 目前 mùqián in front of ones eyes, at present; 目的 mùdì goal, purpose, aim; 目录 mùlù catalogue, list, list of contents<br /><br />{Compare with 自 zì self and 日 rì sun}
華|[huá] glory, splendor, magnificent, (=中华 Zhōnghuá) China<br /><br />[Huà] {family name}>; 华山 Huà Shān (mountain in Shaanxi)
報|[bào] (=报告 bàogào) report, (=报纸 bàozhǐ) newspaper, (=电报 diànbào) telegram
立|[lì] stand, erect, vertical; 建立 jiànlì establish; 立刻 lìkè right away; 立方体 lìfāngtǐ cube
馬|[mǎ] horse; 马上 mǎshàng right away 马马虎虎 mǎmahūhū careless, casual<br /><br />{Compare with 乌 wū crow}
命|[mìng] (=生命 shēngmìng) life, fate, destiny; 命令 mìnglìng command; 革命 gémìng revolution
張|[zhāng] spread, sheet of paper, {classifier for surfaces, tables, postcards, etc.}>; 紧张 jǐnzhāng tense, nervous
活|[huó] live, alive, living, vivid, save someone's life; 生活 shēnghuó life; 活动 huódòng activity
難|[nán] difficult<br /><br />[nàn] disaster
神|[shén] spirit, god; 精神 jīngshén spirit, mind, consciousness, essence
數|[shù] number, number, figure, fate, plan; 数学 shùxué math<br /><br />[shǔ] count, enumerate, list<br /><br />[shuò] frequently, repeatedly
件|[jiàn] item, correspondence, document, {classifier for articles and items}>; 条件 tiáojiàn term, condition
安|[ān] still, quiet; 安全 ānquán safe, secure; 安排 ānpái arrange, plan, fix up
表|[biǎo] show, list, table, form, meter, (F錶) (wrist-)watch
原|[yuán] originally, simple, {family name}>; 原来 yuánlái original, formerly, as a matter of fact; 原因 yuányīn cause, reason
車|[chē] car, vehicle with wheels, {family name}><br /><br />[jū] (a piece in Chinese chess)<br /><br />{Compare with 东 dōng east}
白|[bái] white; 明白 míngbai understand, realize, clear, obvious; 白天 báitiān daytime; 白菜 báicài cabbage<br /><br />[bó] 李白 Lǐ Bó = Lǐ Bái<br /><br />{Compare with 自 zì self and 百 bǎi hundred}
應|[yīng] promise, answer, respond, {family name}>, (=应该 yīnggāi) should, ought to<br /><br />[yìng] 应用 yìngyòng apply
路|[lù] path, way, journey, distance, means, sequence, logic, sort, grade, class, {family name}>, (=道路 dàolù) road
期|[qī] phase, stage, {classifier for issues of periodicals}>, (=时期 shíqī) time period; 班期 bānqī schedule, time table; 星期 xīngqī week; 长期 chángqī long term<br /><br />[jī] anniversary
叫|[jiào] cry out, call; 叫做 jiàozuò be called, be known as
死|[sǐ] die, death
常|[cháng] often, constant, ordinary, {family name}>; 非常 fēicháng extremely
提|[tí] lift, raise, pick up, carry; 提高 tígāo improve; 提供 tígōng provide<br /><br />[dī] 提防 dīfang take precautions or be on guard against
感|[gǎn] (=感觉 gǎnjué) feel, (=感情 gǎnqíng) emotion
金|[jīn] (=金子 jīnzi) gold, (=金属 jīnshǔ) metals in general
何|[hé] what?, where?, how?, {family name}>; 任何 rènhé any; 如何 rúhé how?; 几何 jǐhé geometry
更|[gèng] more, still/even more, furthermore<br /><br />[gēng] replace, transform, night watch; (=更改 gēnggǎi) change, alter<br /><br />{Compare with 吏 lì official and 便 biàn convenient}
反|[fǎn] turn over, return, revolt, (=反对 fǎnduì) oppose, combat; 反映 fǎnyìng reflect<br /><br />[bǎn] 反反 bǎnbǎn proper, fitting<br /><br />{Compare with 友 yǒu friend}
合|[hé] close, shut, accord with, conform to, be equal to, together, jointly, {classifier for rounds}>, (=结合 jiéhé) combine; 合作 hézuò cooperate<br /><br />[gě] decilitre
放|[fàng] put, release, set free, give out, expand, blossom, bloom, lend (money) at interest; 解放 jiěfàng liberate, emancipate
做|[zuò] do, act, make, produce, write, compose, {slang}> to have sex; 叫做 jiàozuò be called, be known as; 做法 zuòfǎ method, way of doing<br /><br />{Sometimes replaceable with 作 zuò do}
系|[xì] series, department, faculty, (=系统 xìtǒng) system, (F係) (=联系 liánxì) integrate, relate to; 关系 guānxi concern, affect, matter, (F繫) tie, fasten, feel anxious, be concerned<br /><br />[jì] (F繫) tie, bind
計|[jì] (=计算 jìsuàn) count, calculate, plot, plan, {family name}>; 统计 tǒngjì statistics
或|[huò] (=或者 huòzhě) or, (=或许 huòxǔ) perhaps, mayby, (=可能 kěnéng) probably<br /><br />{Compare with 國=国 guó country}
司|[sī] 公司 gōngsī company, corporation; 司令 sīlìng commander
利|[lì] (=利益 lìyì) interest, benefit, profit, {family name}>; 利用 lìyòng utilize; 胜利 shènglì triumph; 意大利 Yìdàlì Italy
受|[shòu] receive, endure, (=接受 jiēshòu) accept; 难受 nánshòu unhappy
光|[guāng] light, merely; 阳光 yángguāng sunlight; 光荣 guāngróng glory
王|[wáng] king; 王国 wángguó kingdom, realm, domain<br /><br />[wàng] (rare) rule<br /><br />{Compare with 主 zhǔ lord and 玉 yù jade}
果|[guǒ] fruit, surely, truly, as expected, (=结果 jiéguǒ) result, consequence, outcome; 如果 rúguǒ if
親|[qīn] close relative, kiss; 母亲 mùqin mother; 父亲 fùqin father; 亲自qīnzì in person<br /><br />[qìng] 亲家 qìngjia relatives by marriage
界|[jiè] (=界限 jièxiàn) boundary, limit; 世界 shìjiè world<br /><br />[gā] 不搭界 bù dāgā have no relation, have nothing to do with<br /><br />[gà] 半间不界 bàn'gānbùgà neither this nor that, inexplicit, equivocal, mediocre
及|[jí] reach, come up to, and, in, on, to; 以及 yǐjí as well as; 及时 jíshí promptly
今|[jīn] now, this; 今天 jīntiān today
京|[jīng] capital city, (=北京 Běijīng) short for Beijing; 南京 Nánjīng; 东京 Dōngjīng Tokyo (or other eastern capital in previous dynasties!)
務|[wù] affair, business; 任务 rènwu assignment, task; 服务 fúwù service, serve
制|[zhì] work out, (=制度 zhìdù) system, institution, (=控制 kòngzhì) control, dominate, (F製) (=制造 zhìzào) manufacture
解|[jiě] separate, explain, untie, undo, take off, dissolve, {mathematic}> solution<br /><br />[Xiè] {family name}><br /><br />[jiè] 解送 jièsòng send under guard
各|[gè] each, every, different, separately; 各有千秋 gèyǒuqiānqiū each has his merits<br /><br />[gě] 自各 zìgě oneself, by oneself
任|[rèn] appoint, no matter, serve a position, allow, trust, official post, {classifier for terms of office}>; 任务 rènwu task; 任何 rènhé any<br /><br />[Rén] {family name}>
至|[zhì] to, until, extremely, most, arrive, reach; 甚至 shènzhì even (to the point of), so much so that; 至少 zhìshǎo at least
清|[qīng] (=清楚 qīngchu) clear; 清洁 qīngjié clean
物|[wù] thing, matter; 动物 dòngwù animal; 植物 zhíwù plant; 物理 wùlǐ physics
台|[tái] {polite}> you, (F臺) platform, {classifier for performances, engines, computers, TV-sets, etc.}>, (=台湾 Táiwān) short for Taiwan, (F檯) desk, table, (F颱) 台风 táifēng typhoon<br /><br />[tāi] 天台 Tiāntāi (in eastern Zhejiang)
象|[xiàng] appearance, likeness, (=大象 dàxiàng) elephant
記|[jì] (=记得 jìde) remember, (=记录 jìlù) record<br /><br />{Compare with the "open" radical 己 jǐ self and not the close 已 yǐ already}
邊|[biān] on the side of something, margin, limit, {family name}>, (=旁边 pángbiān) side; 这边 zhèbiān over here
共|[gòng] share; 一共 yígòng in all; 共产 gòngchǎn communist; 公共 gōnggòng public; 共和 gònghé republic
風|[fēng] wind
戰|[zhàn] (=战争 zhànzhēng) war
干|[gān] stem; 干涉 gānshè interfere, intervene, (F乾) dry<br /><br />[gàn] (F幹) do<br /><br />{天干 tiāngān the Ten Heavenly Stems: 甲乙丙丁戊己庚辛壬癸 jiǎ-yǐ-bǐng-dīng-wù-jǐ-gēng-xīn-rén-guǐ (these characters are sometimes used as ordinal numbers}<br /><br />{Compare with 千 qiān thousand and于 yú at}
接|[jiē] connect, (=接受 jiēshòu) accept; 接着 jiēzhe catch, next; 直接 zhíjiē direct
它|[tā] it, its
許|[xǔ] allow, somewhat, {family name}>, (=也许 yěxǔ) perhaps; 许多 xǔduō a lot<br /><br />[hǔ] 邪许 yéhǔ yell in unison, yo-ho-ho
八(A捌)|[bā] eight; 八月 Bāyuè August
特|[tè] (=特别 tèbié) special, particular; 特点 tèdiǎn characteristic
覺|[jué] perceive<br /><br />[jiào] (=睡觉 shuìjiào) sleep; 午觉 wǔjiào siesta, afternoon nap
望|[wàng] look, full moon; 希望 xīwàng hope, wish
直|[zhí] straight, directly<br /><br />{Compare with 真 zhēn true}
服|[fú] (=服务 fúwù) serve, (=衣服 yīfu) clothes<br /><br />[fù] dose
毛|[máo] hair<br /><br />{Compare with 手 shǒu hand}
林|[lín] (=森林 sēnlín) forest, {family name}>; 桂林 Guìlín (city in Guangxi)
題|[tí] topic, problem, inscribe; 问题 wèntí question, problem; 题目 tímù title
建|[jiàn] construct, establish; 建议 jiànyì suggest
南|[nán] south; 西南 xīnán southwest<br /><br />[nā] 南无 nāmó 〈Sanskrit〉 to give oneself totally to
度|[dù] degree, extent, unit (kWh, angle, temperature, etc.), {classifier for units of measurement, occasions, times, etc.}>; 制度 zhìdù system, institution<br /><br />[duó] 猜度 cāiduó surmise
統|[tǒng] order, unite, (=系统 xìtǒng) system; 统治 tǒngzhì rule, dominate; 统一 tǒngyī together, unify, unite, integrate
色|[sè] (=颜色 yánsè) colour; 脸色 liǎnsè complexion, look, facial expression<br /><br />[shǎi] colour
字|[zì] written character; 汉字 Hànzì Chinese character; 名字 míngzi name; 体字 tǐzì style of written Chinese, typface, font<br /><br />{Compare qith 学 xué study}
請|[qǐng] please, request, invite; 请求 qǐngqiú ask, request
交|[jiāo] join; 交通 jiāotōng traffic; 交换 jiāohuàn exchange
愛|[ài] (=爱情 àiqíng) love; 爱人 àirén spouse, lover
讓|[ràng] let, allow
認|[rèn] (=认为 rènwéi) consider, (=认识 rènshi) recognize
算|[suàn] (=计算 jìsuàn) count, calculate, compute; 算了 suànle forget it, never mind
論|[lùn] theory<br /><br />[Lún] 论语 Lúnyǔ The Confucian Analects
佰|[bǎi] hundred<br /><br />[bò] 抄总 chāobòzǒng express/cover everything<br /><br />{Compare with 白 bái white}
吃|[chī] eat<br /><br />[qī] 吃吃 qīqī {the sound of giggling}>
義|[yì] justice, (=意义 yìyì) meaning; 主义 zhǔyì ~ism
科|[kē] department; 科学 kēxué science; 外科 wàikē surgery
怎|[zěn] (=怎么 zěnme) how?
元|[yuán] first, primary, dollar
社|[shè] club, organized body, (=社会 shèhuì) society
術|[shù] skill, (=艺术 yìshù) art; 技术 jìshù technique<br /><br />[zhú] 术酒 zhújiǔ medicinal wine
結|[jié] tie; 结果 jiéguǒ result; 结婚 jiéhūn marry<br /><br />[jiē] bear fruit
六(A陆,陸)|[liù] six; 六月 liùyuè June<br /><br />{Compare with 兴 xìng prosper}
功|[gōng] achievement; 成功 chénggōng succeed; 功夫 gōngfu time (duration), time (when), skill, art, work
指|[zhǐ] point, (=指头 zhǐtou) finger, toe; 指甲 zhǐjia finger nail
思|[sī] (=思想 sīxiǎng) thought<br /><br />[si] 意思 yìsi meaning<br /><br />[sāi] 于思 yúsāi richly bearded
非|[fēi] not, non-; 非常 fēicháng unusually, extraordinary, special, very, extremely
流|[liú] to flow, stream; 电流 diànliú electric current; 交流 jiāoliú to exchange, alternate
每|[měi] every, each; 每天 měitiān every day
青|[qīng] nature's colour blue/green/black...; 青年 qīngnián youth; 青蛙 qīngwā frog
管|[guǎn] tube, (=管理 guǎnlǐ) manage, supervise; 不管 bùguǎn no matter, regardless of
夫|[fū] man, (=丈夫 zhàngfu) husband; 工夫 gōngfu time, duration, skill; 大夫 dàifu doctor<br /><br />[fú] (formal) this/that (person)<br /><br />{Compare with 天 tiān heaven and 失 shī lose}
連|[lián] connect, including; 连忙 liánmáng right away; 连续 liánxù continuous
遠|[yuǎn] far
資|[zī] money, expenses; 资本主义 zīběnzhǔyì capitalism; 投资 tóuzī invest
隊|[duì] team, (=部队 bùduì) army, (=队伍 duìwǔ) troops
跟|[gēn] heel, follow, with, and
帶|[dài] belt, zone, carry, bring, take
花|[huā] flower, spend; 花生 huāshēng peanut
快|[kuài] fast, sharp, (=快乐 kuàilè, =愉快 yúkuài) happy
條|[tiáo] twig, strip, item, {classifier for dogs, snakes, dragons, etc.}>; 条件 tiáojiàn condition, term
院|[yuàn] courtyard; 学院 xuéyuàn college; 医院 yīyuàn hospital; 法院 fǎyuàn court
變|[biàn] change; 变成 biànchéng become; 变化 biànhuà variation; 改变 gǎibiàn alter
聯|[lián] unite, join; 联系 liánxì integrate, relate, link, get in touch with
言|[yán] words; 语言 yǔyán language, speech, word
權|[quán] right, power
往|[wǎng] to, toward; 往往 wǎngwǎng often
展|[zhǎn] expand, spread out, {family name}>; 发展 fāzhǎn develop, expand, grow; 展览 zhǎnlǎn exhibit, show, display
該|[gāi] (=应该 yīnggāi) should
領|[lǐng] to lead, collar; 领导 lǐngdǎo, 领袖 lǐngxiù leader; 本领 běnlǐng ability
傳|[chuán] pass, pass on; 传统 chuántǒng tradition<br /><br />[zhuàn] Confucian classic
近|[jìn] near; 附近 fùjìn vicinity; 最近 zuìjìn recently, lately, soon
留|[liú] remain, stay, (=保留 bǎoliú) keep, reserve; 留学 liúxé to study abroad; 遗留 yíliú hand down; 拘留 jūliú arrest
紅|[hóng] (=红色 hóngsè) red; 东方红 Dōngfānghóng The East is Red<br /><br />[gōng] 女红 nǚgōng needlework
治|[zhì] govern, cure, punish; 政治 zhèngzhì government
決|[jué] 解决 jiějué solve, resolve, settle; 决定 juédìng decide, resolve, make up one's mind
周|[zhōu] circuit, circumference, cycle, week; 周围 zhōuwéi vicinity, surroundings, entirely; 周身 zhōushēn whole vody
保|[bǎo] (=保护 bǎohù) protect; 保证 bǎozhèng ensure, guarantee
達|[dá] reach, arrive<br /><br />[dā] {referring to sounds of clocks or footsteps}><br /><br />[tà] 挑达 tāotà walk casually to and fro
辦|[bàn] do; 办法 bànfǎ method; 办公室 bàngōngshì office<br /><br />{Compare with 为 wèi for}
運|[yùn] carry, transport, (运气 yùnqi) fortune, luck; 运动 yùndòng move, turn around, sports
武|[wǔ] military; 武器 wǔqì weapon; 武术 wǔshù martial arts
半|[bàn] half, semi~<br /><br />{Compare with 平 píng even}
候|[hòu] (=时候 shíhou) time, wait, situation
七(A柒)|[qī] seven; 七月 qīyuè July
必|[bì] (=必须 bìxū) must; 不必 búbì needn't
城|[chéng] (=城市 chéngshì) city, wall; 长城 chángchéng Great Wall
父|[fù] (=父亲 fùqin) father; 父母 fùmǔ parents<br /><br />[fǔ] old man
強,彊|[qiáng] strong<br /><br />[qiǎng] strive<br /><br />[jiàng] 倔强 juéjiàng stubborn, unbending
步|[bù] step; 进步 jìnbù progress, improve; 散步 sànbù take a walk
完|[wán] finished, complete
革|[gé] leather; 革命 gémìng revolution; 改革 gǎigé reform<br /><br />[jí] 病革 bìngjí about to die of illness
深|[shēn] deep; 深刻 shēnkè deep, profound; 深夜 shēnyè deep in the night
區|[qū] (=地区 dìqū) area; 区别 qùbié difference<br /><br />[ōu] {family name}>
即|[jí] namely, that is, even if, (=立即 lìjí) immediately, at once
求|[qiú] seek, ask; 要求 yāoqiú demand, request, requirement
品|[pǐn] (=产品 chǎnpǐn) product; 商品 shāngpǐn merchandise, goods
士|[shì] scholar; 博士 bóshì Ph.D; 女士 nǚshì lady, Ms.; 战士 zhànshì soldier<br /><br />{Compare with 土 tǔ earth}
轉|[zhuǎn] turn, transfer<br /><br />[zhuàn] rotate<br /><br />[zhuǎi] 转文 zhuǎiwén to flaunt one's speach
量|[liàng] amount; 量词 liàngcí classifier, measure word<br /><br />[liáng] to measure
空|[kōng] empty, sky<br /><br />[kòng] leave empty, free time
眾|[zhòng] crowd, many; 群众 qúnzhòng the masses; 听众 tīngzhòng audience
技|[jì] 技术 jìshù technology, technique; 科技 kējì science and technology
輕|[qīng] light (compare with 重 zhòng heavy)
程|[chéng] 过程 guòchéng process; 工程 gōngchéng engineering project; 程度 chéngdu level, degree, extent
告|[gào] (=告诉 gàosu) tell; 报告 bàogào report, make known<br /><br />[gù] 告朔 gùshuò distributing feudal calendar
江|[jiāng] river; 长江 Cháng Jiāng Yangtze River; 江山 jiāngshān landscape
語|[yǔ] (=语言 yǔyán) language; 汉语 Hànyǔ Chinese; 语法 yǔfǎ grammar; 成语 chéngyǔ idiom<br /><br />[yù] tell
英|[yīng] brave, outstanding person, (=英雄 yīngxióng) hero; 英国 Yīngguó England
基|[jī] 基础 jīchǔ base, foundation; 基本 jīběn basic, fundamental, essential
派|[pài] faction, send; 党派 dǎngpài political parties<br /><br />[pā] 派司 pāsi passport, identification
滿|[mǎn] full; 满足 mǎnzú satisfied, contented
式|[shì] (=形式 xíngshì) form; 方式 fāngshì way, pattern; 正式 zhèngshì formal, official
李|[lǐ] (=李子 lǐzi) plum, {family name}>
息|[xī] breath, stop<br /><br />[xi] 消息 xiāoxi news; 休息 xiūxi rest
寫|[xiě] write; 描写 miáoxiě describe, depict<br /><br />[xiè] 写意 xiěyǐ freehand brushwork, sketch<br /><br />{Compare with 与 yǔ and}
呢|[ne] {sentence final particle}><br /><br />[ní] woolen cloth
識|[shí] know; 认识 rènshi know, recognize; 识别 shíbié tell apart<br /><br />[zhì] (formal) remember, commit to memory, mark, sign
極|[jí] extreme, pole; 太极 Tài Jí the Supreme Ultimate (in Chinese cosmology); 太极拳 tǎijíquán shadowboxing
令|[lìng] make, cause; 命令 mìnglìng command<br /><br />[lǐng] ream, {classifier for paper}><br /><br />[líng] 脊令 jílíng (=鹡鸰 jílíng) wagtail (a symbol of brotherly friendship)
黃|[huáng] (=黄色 huángsè) yellow
德|[dé] virtue; 道德 dàodé ethics; 德国 Déguó Germany
收|[shōu] gather, (=收到 shōudào) recieve, (=收获 shōuhuò) harvest; 收拾 shōushi put in order; 收音机 shōuyīnjī radio
臉|[liǎn] face
錢|[qián] money, copper coin
黨|[dǎng] (political) party, clique; 共产党 Gòngchǎndǎng Communist Party; 国民党 Guómíndǎng Nationalist Party
倒|[dǎo] fall down, topple<br /><br />[dào] invert, (move) backwards, pour, contrary to expectations<br /><br />[dáo] follow up
未|[wèi] have not, did not; 未来 wèilái future<br /><br />{Compare with 末 mò end}
持|[chí] hold; 坚持 jiānchí persist in, insist on; 保持 bǎochí keep, maintain, preserve
取|[qǔ] take, get, fetch
設|[shè] set up; 建设 jiànshè build, construct; 设计 shèjì design, plan; 设备 shèbèi equipment, facilities
始|[shǐ] (=开始 kāishǐ) begin, start; 始终 shǐzhōng all along
版|[bǎn] printing plate, edition; 出版 chūbǎn publish
雙|[shuāng] pair, twin, double; 双方 shuāngfāng both sides
历|[lì] (F歷) 历史 lìshǐ history; 经历 jīnglì experience, (F曆) 日历 rìlì calendar<br /><br />{Compare with 厉 lì severe}
越|[yuè] 越…越… the more... the more...
史|[shǐ] (=历史 lìshǐ) history, {family name}>; 外史 wàishǐ unofficial history<br /><br />{Compare with 吏 lì official and 更 gèng more}
商|[shāng] discuss, business
仟|[qiān] thousand<br /><br />{Compare with 干 gān stem and 于 yú at}
片|[piàn] slice; 照片 zhàopiàn photo; 片刻 piànkè moment; 卡片 kǎpiàn card<br /><br />[piān] film
容|[róng] contain; 容易 róngyì easy; 内容 nèiróng content
研|[yán] grind, (=研究 yánjiū) study, research
像|[xiàng] resemble, (=肖像 xiàoxiàng) portrait, image
找|[zhǎo] look for, seek<br /><br />{Compare with 我 wǒ me}
友|[yǒu] (=朋友 péngyǒu) friend; 友好 yǒuhǎo friendship<br /><br />{Compare with 反 fǎn turn over}
孩|[hái] (=孩子 háizi, =小孩儿 xiǎoháir) child; 女孩儿 nǚháir girl
站|[zhàn] stand; 火车站 huǒchēzhàn train station
廣|[guǎng] wide, extensive<br /><br />[yǎn] (when referring to the radical)
改|[gǎi] (=改变 gǎibiàn) change; 改革 gǎigé reform
議|[yì] (=议论 yìlùn) discuss, confer; 会议 huìyì meeting, conference; 建议 jiànyì suggest, propose
形|[xíng] (=形式 xíngshì) form, shape; 形成 xíngchéng to form, take shape
委|[wěi] 委员会 wěiyuánhuì committee; 委托 wěituō entrust<br /><br />[wēi] 虚与委蛇 xūyǔwēiyí to pretend interest and sympathy
早|[zǎo] early; 早饭 zǎofàn breakfast; 早晨 zǎochen morning
房|[fáng] (=房间 fángjiān) room, (=房子 fángzi) building
音|[yīn] (=声音 shēngyīn) sound; 音乐 yīnyuè music
火|[huǒ] fire; 火车 huǒchē train; 火柴 huǒchái match; 火焰 huǒyàn flame
際|[jì] (=边际 biānjì) boundary; 实际 shíjì reality; 国际 guójì international
則|[zé] (conjunction); 原则 yuánzé principle; 否则 fǒuzé or else
首|[shǒu] head; 首先 shǒuxiān first of all; 首都 shǒudū capital (of a country)
單|[dān] alone, single, sheet<br /><br />[chán] 单于 chányú {hist.}> chief of the Xiongnu<br /><br />[Shàn] {family name}>
據|[jù] seize, depend on, (=根据 gēnjù) according to<br /><br />[jū] 拮据 jiéjū short of money, hard up
導|[dǎo] lead; 领导 lǐngdǎo leader
影|[yǐng] shadow, image; 电影 diànyǐng movie
失|[shī] lose; 失败 shībài be defeated<br /><br />{Compare with 先 xiān first}
拿|[ná] hold; 拿来 nálái bring; 拿去 náqù take; 拿给 nágěi hand over
網|[wǎng] net; 网球 wǎngqiú tennis; 因特网 yīntèwáng Internet
香|[xiāng] perfume, fragrant; 香港 Xiānggǎng Hong Kong
似|[sì] similar; 似乎 sìhu it seems<br /><br />[shì] 似的 shìde alike
斯|[sī] thus (nowadays used mostly as a phonem in foreign names); 法西斯 fǎxīsī Fascist
專,耑|[zhuān] (=专门 zhuānmén) special, (=专家 zhuānjiā) expert; 专政 zhuānzhèng dictatorship
石|[shí] (=石头 shítou) stone, rock<br /><br />[dàn] unit of grain<br /><br />{Compare with 右 yòu right}
若|[ruò] seem, as if; 假若 jiǎruò if; 若干 ruògān how much?<br /><br />[rě] 般若 bōrě buddhist widom, prajna
兵|[bīng] (=士兵 shìbīng) soldier; 兵力 bīnglì military strength<br /><br />{Compare with 宾 bīn guest}
弟|[dì] (=弟弟 dìdi) younger brother<br /><br />[tì] (=悌)
誰|[shuí] who?<br /><br />[shéi] who?
校|[xiào] (=学校 xuéxiào) school<br /><br />[jiào] (=校对 jiàoduì, 校正 jiàozhèng) proofread
讀|[dú] read<br /><br />[dòu] pause in reading
志|[zhì] (=意志 yìzhì) will, (=标志 biāozhì) mark; 同志 tóngzhì comrade, (F誌) 杂志 zázhì magazine
飛|[fēi] fly; 飞机 fēijī airplane
觀|[guān] view, contemplation<br /><br />[guàn] 道观 Dàoguàn Daoist temple
爭|[zhēng] contend, dispute; 战争 zhànzhēng war, warfare; 斗争 dòuzhēng fight, struggle
究|[jiū] 研究 yánjiū study, research; 究竟 jiūjìng after all
包|[bāo] bag, wrap
組|[zǔ] organize, group; 组织 zǔzhī organization, organize, form
造|[zào] (=制造 zhìzào) manufacture, (=创造 chuàngzào) create
落|[luò] fall<br /><br />[là] be missing<br /><br />[lào] 落色 làoshǎi fade (in colour)<br /><br />[luō] 空落落 kōngluōluō absolutely nothing left, open/spacious and desolate
視|[shì] look; 电视 diànshì television
濟|[jì] 经济 jīngjì economy; 救济 jiùjì help disaster victims<br /><br />[jǐ] 济济 jǐjǐ multitudinous, numerous, magnificent
喜|[xǐ] happiness; 喜欢 xǐhuān like
離|[lí] (=离开 líkāi) leave, from
雖|[suī] (=虽然 suīrán) although
坐|[zuò] seat, sit, travel by (car/plane/etc.), put a kettle (or similar) on the fire, {classifier for bridges, buildings, etc.}>; 请坐 qǐngzuò please have a seat; 坐公共汽车 zuò gōngòng qìchē ride a bus
集|[jí] (=收集 shōují) collect; 集中 jízhōng centralize
編|[biān] weave, organize, (=编辑 biānjí) edit
寶|[bǎo] treasure
談|[tán] talk
府|[fǔ] 政府 zhèngfǔ government
拉|[lā] pull, drag, haul<br /><br />[lǎ] 半拉 bànlǎ half<br /><br />[lá] slit<br /><br />[là] 拉拉蛄 làlagù mole cricket
黑|[hēi] (=黑色 hēisè) black; 黑暗 hēi'àn dark
且|[qiě] for the time being; 而且 érqiě furthermore<br /><br />[jū] (only used some personal names)
隨|[suí] follow; 随便 suíbiàn as you like
格|[gé] check, pattern, standard; 格外 géwài especially<br /><br />[gē] {the sound of laughter, clicking of a hen}>, chuckel
尽|[jìn] (F盡) use up<br /><br />[jǐn] (F儘) to max extent; 尽管 jǐnguǎn even though
劍|[jiàn] sword; 宝剑 bǎojiàn double-edged sword
講|[jiǎng] speak, explain, discuss, stress
布|[bù] cloth, spread
殺|[shā] kill, fight, weaken, reduce, burn (of medicine)
微|[wēi] tiny, micro; 微笑 wēixiào smile
怕|[pà] (=害怕 hàipà) to fear; 可怕 kěpà horrible
母|[mǔ] (=母亲 mǔqin) mother; 父母 fùmǔ parents; 字母 zìmǔ letters of an alpabet
調|[diào] shift, tone<br /><br />[tiáo] adjust
局|[jú] department, situation; 邮局 yóujú post office
根|[gēn] root; 根本 gēnběn essence, foundation, basic, utterly, (not) at all
曾|[céng] (=曾经 céngjīng) in the past<br /><br />[zēng] great- (grandmother)<br /><br />[cēng] 挨曾儿 āicēngr 〈colloquial〉 to get a scolding
准|[zhǔn] allow, (F準) certainly, precise; 准备 zhǔnbèi prepare; 标准 biāozhǔn standard
團|[tuán] ball, lump, group; 团结 tuánjié unite, rally
段|[duàn] section, paragraph; 手段 shǒuduàn method, means (to an end), strategy
終|[zhōng] end; 终于 zhōngyú finally; 始终 shǐzhōng all along; 终身 zhōngshēn life-long
樂|[lè] enjoy, be glad, pleasure, (=快乐 kuàilè) happy<br /><br />[yuè] (=音乐 yīnyuè) music
切|[qiē] to cut<br /><br />[qiè] correspond to; 一切 yíqiè all
級|[jí] grade, level; 阶级 jiējí (social) class, steps, stairs, rank
克|[kè] (=克服 kèfú) overcome, gram, (F剋) 克期 kèqī set time limit<br /><br />[kēi] (=剋) scold
精|[jīng] perfect; 精神 jīngshén spirit, essence; 酒精 jiǔjīng alcohol
哪|[nǎ] what? 哪儿 nǎr where?<br /><br />[něi] (before classifier) which?<br /><br />[na] (used in orders and exclamations)<br /><br />[Né] (in foreign names)
官|[guān] official; 官僚 guānliáo bureaucrat
示|[shì] (=表示 biǎoshì) show, indicate; 指示 zhǐshì point out
冲|[chōng] (F沖) rinse, rush, (F衝) rush<br /><br />[chòng] (F衝) towards
竟|[jìng] finish, (=竟然 jìngrán) unexpectedly; 究竟 jiūjìng actually, exactly, in the end, after all
乎|[hū] 似乎 sìhu it seems; 几乎 jīhū almost
男|[nán] male, (=男人 nánrén) man
舉|[jǔ] raise; 举行 jǔxíng hold (a meeting); 选举 xuǎnjǔ election; 举例 jǔlì give an example
客|[kè] (=客人 kèrén) guest; 客观 kèguān objective; 客气 kèqi polite
證,証|[zhèng] prove; 图书证 túshūzhèng library card; 签证 qiānzhèng visa
苦|[kǔ] bitter; 艰苦 jiānkǔ arduous; 痛苦 tòngkǔ suffering
照|[zhào] shine; 照相 zhàoxiàng photo
注|[zhù] pour, (F註) notes; 注意 zhùyì pay attention; 注视 zhùshì gaze
費|[fèi] cost; 学费 xuéfèi tuition
足|[zú] foot, (=足够 zúgòu) enough; 满足 mǎnzú satisfy
爾|[ěr] {archaic}> you; 尔后 ěrhòu thereafter; 高尔夫 gāo'ěrfū golf
招|[zhāo] beckon, recruit, attract; 招待 entertain (guests)
群|[qún] crowd, group; 群众 qúnzhòng The Masses
熱|[rè] hot
推|[tuī] push
晚|[wǎn] late; 晚上 wǎnshang evening; 夜晚 yèwǎn night; 晚饭 wǎnfàn dinner
響|[xiǎng] sound; 影响 yǐngxiǎng influence
稱|[chēng] weigh, name<br /><br />[chèn] 对称 duìchèn symmetric
興|[xìng] 高兴 gāoxìng glad<br /><br />[xīng] 兴奋 xīngfèn excited<br /><br />{Compare with 六 liù six}
待|[dài] treat, entertain, wait for<br /><br />[dāi] (=呆 dāi) stay
約|[yuē] approximately, arrange, appointment<br /><br />[yāo] weigh
陽|[yáng] opposite of 阴 yīn; 太阳 tàiyáng the sun
哥|[gē] (=哥哥 gēge) older brother
驚|[jīng] surprise
嗎|[ma] {interrogative particle}><br /><br />[má] what; 干吗? gàn má? What's up?<br /><br />[mǎ] 吗啡 mǎfēi morphine
整|[zhěng] (=整个 zhěnggè) whole; 调整 tiáozhěng adjust; 整齐 zhěngqí neat
支|[zhī] branch, support; 支持 zhīchí sustain; 地支 dìzhī the Twelve Terrestrial Branches
古|[gǔ] (=古代 gǔdài) ancient<br /><br />{Compare with 舌 shé tongue}
漢|[hàn] Chinese ethnicity; 汉语 hànyu Chinese; 汉字 hànzi Chinese character; 老汉 lǎohàn old man
突|[tū] charge forward, stick out; 突然 tūrán suddenly
號|[hào] name, number, mark<br /><br />[háo] yell
絕|[jué] cut off, absolute
選|[xuǎn] (=选择 xuǎnzé) choose, select; 选举 xuǎnjǔ election
吧|[ba] at end of sentence, indicates suggestion<br /><br />[bā] snap!
參|[cān] 参加 cānjiā participate<br /><br />[shēn] 人参 rénshēn ginseng<br /><br />[cēn] 参差 cēncī uneven, irregular
刊|[kān] periodical, publication; 报刊 bǎokān periodical publications, the press
亞|[yà] inferior, second; 亚洲 Yàzhōu Asia
复|[fù] (F復) 恢复 huīfù recover, (F複) 复杂 fùzá complicated, complex, (F覆) cover
傷|[shāng] wound, injury, injure; 创伤 chuāngshāng trauma
類|[lèi] category, kind, type; 类似 lèisì similar
備|[bèi] (=准备 zhǔnbèi) get ready, prepare; 设备 shèbèi equipment
歡|[huān] (=欢乐 huānlè) happy, joyous; 喜欢 xǐhuan like
另|[lìng] other; 另外 lìngwài other, besides
港|[gǎng] harbor; 香港 Xiānggǎng Hong Kong
勢|[shì] power; 形势 xíngshì circumstances; 姿势 zīshì posture
刻|[kè] carve, quarter hour, moment
星|[xīng] star; 火星 huǒxīng Mars; 星期 xīngqī week
斷|[duàn] cut off; 不断 búduàn unceasing; 判断 pànduàn judge
陳|[chén] display, explain, stale, (dynasty 557-589)
掌|[zhǎng] palm of the hand; 掌握 zhǎngwò grasp
農|[nóng] (=农民 nóngmín) farmer, peasant; 农业 nóngyè agriculture
夜|[yè] (=夜晚 yèwǎn) night; 半夜 bànyè, 午夜 wǔyè midnight; 夜里 yèlǐ at night
般|[bān] sort, kind; 一般 yìbān ordinary<br /><br />[pán] happy<br /><br />[bō] 般若 bōrě buddhist wisdom, prajna
唸|[niàn] miss, read aloud; 观念 guānniàn concept; 念书 niànshū study
价|[jià] (F價) (=价值 jiàzhí) value, (=价钱 jiàqian) price<br /><br />[jie] (F價)<br /><br />[jiè] servant
腦|[nǎo] (=脑子 nǎozi) brain; 脑袋 nǎodai head; 脑壳 nǎoké skull; 电脑 diànnǎo computer
規|[guī] 规律 guīlǜ regular pattern; 规定 guīdìng regulations
底|[dǐ] bottom; 彻底 chèdǐ thorough; 到底 dàodǐ after all
故|[gù] cause, therefore; 故事 gùshi story; 故意 gùyì on purpose
省|[shěng] province, economize, omit<br /><br />[xǐng] 反省 fǎnxǐng introspection
媽|[mā] mother, mom; 妈妈 māma mama
剛|[gāng] firm, (=刚才 gāngcái) just (a moment ago)
句|[jù] sentence
顯|[xiǎn] appear; 显然 xiǎnrán obvious
消|[xiāo] disappear; 消息 xiāoxi news; 消灭 xiāomiè perish
衣|[yī] (=衣服 yīfu) clothing<br /><br />[yì] wear (clothing), give (clothing) to others to wear
陸|[lù] land; 大陆 continent<br /><br />[liù] six (= 六 liù)
器|[qì] utensil, (=机器 jīqi) machine; 武器 wǔqì weapon
確|[què] true; 正确 zhèngquè correct; 确实 quèshí indeed; 明确 míngquè explicit
破|[pò] smash; 破坏 pòhuài ruin; 破烂 pòlàn worn out
具|[jù] 工具 gōngjù tool; 具有 jùyǒu possess; 具体 jùtǐ concrete; 玩具 wánjù toy
居|[jū] (=居住 jūzhù) live, reside; 居民 jūmín resident; 居然 jūrán unexpectedly
批|[pī] {classifier for a batch/lot}>, comment, criticize, refute; 批评 pīpíng criticize
送|[sòng] see somebody off, deliver, give
澤|[zé] 沼泽 zhǎozé marsh, swamp; 色泽 sèzé colour and lustre; 毛泽东 Máo Zédōng CCP leader and founder of the PRC
緊|[jǐn] tight; 紧张 jǐnzhāng tense; 要紧 yàojǐn important
幫|[bāng] (=帮助 bāngzhù, 帮忙 bāngmáng) help, gang
線|[xiàn] line, thread; 光线 guāngxiàn light ray; 电线 diànxiàn (electric) wire
存|[cún] (=存在 cúnzài) exist; 保存 bǎocún preserve
願|[yuàn] wish
奇|[qí] marvellous, (=希奇 xīqí) rare, strange<br /><br />[jī] odd (not even)
害|[hài] harmful; 害虫 hàichóng destructive insect; 厉害 lìhai fierce
增|[zēng] (=增加 zēngjiā, =增长 zēngzhǎng) increase
楊|[yáng] poplar tree; 三角叶杨 sānjiǎoyèyáng cottonwood
料|[liào] (=材料 cáiliào) material, expect, anticipate; 资料 zīliào means, data, material
州|[zhōu] prefecture; 广州 Guǎngzhōu Canton
節|[jié] joint, section, festival, holiday, (=节日 jiérì) holiday<br /><br />[jiē] knot, link; 节子 jiēzi gnarl, knot (in wood)
左|[zuǒ] left; 左边 zuǒbiān left side
裝|[zhuāng] dress up, load, install, (=假装 jiǎzhuāng) pretend
易|[yì] (=容易 róngyì) easy, change; 易经 Yìjīng Book of Changes
急|[jí] urgent; 着急 zháojí anxious; 急忙 jímáng in a hurry
久|[jiǔ] (for a) long time
低|[dī] low; 降低 jiàngdī reduce; 低级 dījí elementary; 高低 gāodī height
歲|[suì] years old; 岁数 suìshu age; 万岁 wànsuì long life, Your/His Majesty, "Banzai"
需|[xū] (=需要 xūyào) need; 必需 bìxū essential
酒|[jiǔ] wine; 啤酒 píjiǔ beer; 喝酒 hējiǔ drink wine
河|[hé] river; 河南省 Hénán shěng Henan Province; 运河 yùnhé canal
初|[chū] beginning, first (in order); 初步 chūbù preliminary; 起初 qǐchū at first
游|[yóu] (=游泳 yóuyǒng) swim, (=旅游 lǚyóu) travel
嚴|[yán] severe, stern
鐵|[tiě] iron; 地铁 dìtiě underground, subway
族|[zú] (=民族 mínzú) people, nationality, (=种族 zhǒngzú) race
除|[chú] get rid of, divide, (=除了 chúle) except
份|[fèn] portion, share, copy, {classifier for portion, share, copies of newspapers etc.}>, college degree
敢|[gǎn] dare; 勇敢 yǒnggǎn brave
胡|[hú] recklessly; 胡说 nonsense (F鬍) (=胡子 húzi) beard (F衚) 胡同 hútòng lane
血|[xuè] blood<br /><br />[xiě] blood
企|[qǐ] stand on tiptoe, hope for, look forward to; 企业 qǐyè enterprise; 企图 qǐtú attempt; 企鹅 penguin
仍|[réng] (=仍然 réngrán, =仍旧 réngjiù) still, yet, as before
投|[tóu] throw; 投票 tóupiào vote
聞|[wén] smell, hear; 新闻 xīnwén news
斗|[dǒu] 10 liters; 烟斗 yāndǒu tobacco/opium pipe; 北斗星 Běidǒuxīng The Big Dipper, The Plow<br /><br />[dòu] (F鬥) fight
紀|[jì] 世纪 shìjì century; 纪念 jìniàn memento; 纪律 jìlǜ discipline<br /><br />[Jǐ] {family name}>
腳|[jiǎo] foot; 赤脚 chìjiǎo barefoot; 脚趾 jiǎozhǐ toe<br /><br />[jué] (=角 jiǎo) role, part, character, actor, actress
右|[yòu] right; 右边 yòubiān right side; 左右 zuǒyòu around, nearby, more or less<br /><br />{Compare with 石 shí stone}
蘇|[sū] 苏醒 sūxǐng revive; 苏州 Sūzhōu; 苏联 Sūlián USSR
標|[biāo] mark; 标准 biāozhǔn standard
飯|[fàn] rice, food
云|[yún] say, (F雲) (=云彩 yúncai) cloud
病|[bìng] sick; 毛病 máobing malfunction
醫|[yī] (=医学 yīxué) medical science; 医生 yīshēng doctor; 医院 yīyuàn hospital
阿|[ā] 阿拉伯 ālābó Arab<br /><br />[ē] 阿弥陀佛ēmítuógó Amitabha = Buddha preserve us
答|[dá] (=回答 huídá) answer<br /><br />[dā] 答应 dāying respond, promise
土|[tǔ] earth, (=土地 tǔdì) land, (=土壤 tǔrǎng) soil<br /><br />{Compare with 士 shì scholar}
況|[kuàng] 情况 qíngkuàng circumstances; 况且 kuàngqiě moreover
境|[jìng] border, territory; 环境 huánjìng environment
軟|[ruǎn] soft; 软件 ruǎnjiàn software
考|[kǎo] (=考虑 kǎolǜ) consider, (=考试 kǎoshì) exam
娘|[niáng] mother, aunt<br /><br />[niang] 姑娘 gūniang girl
村|[cūn] village, rustic; 农村 nóngcūn countryside, village
刀|[dāo] knife
擊|[jī] beat, strike, knock; 打击 dǎjī strike, hitt, attack, assault
僅|[jǐn] (=仅仅 jǐnjǐn) only, barely
查|[chá] examine, investigate; 检查 jiǎnchá inspect<br /><br />[Zhā] {family name}>
引|[yǐn] draw, stretch, (=引起 yǐnqǐ) cause, (=吸引 xīyǐn) attract
朝|[cháo] towards, dynasty; 朝鲜 Cháoxiān Korea<br /><br />[zhāo] (morning)
育|[yù] raise, educate; 教育 jiàoyù education<br /><br />[yō] 杭育 hángyō heave-ho, yo-ho
續|[xù] (=继续 jìxù) continue; 连续 liánxù continuous
獨|[dú] only, alone; 独立 dúlì independent
羅|[luó] (=罗网 luówǎng) birdnet; 罗马 Luómǎ Rome; 罗盘 luópán compass<br /><br />[luō] 罗嗦 luōsuo wordy, troublesome; 哩哩罗罗 līliluōluō the sound of boiling/rumbling/etc.
買|[mǎi] buy
戶|[hù] door, household; 窗户 chuānghù window
護|[hù] (=保护 bǎohù) guard, protect; 护士 hùshi nurse
喝|[hē] drink<br /><br />[hè] shout
朋|[péng] 朋友 péngyǒu friend<br /><br />{Compare with 丽 lì beautiul and 册 cè book}
供|[gōng] supply<br /><br />[gòng] confess
責|[zé] duty; 责任 zérèn responsibility
項|[xiàng] (=项目 xiàngmù) item
背|[bèi] back<br /><br />[bēi] carry on the back
余|[yú] I, me, (F餘) left-over, extra; 其余 the rest; 余弦 cosine
希|[xī] sparse, scattered, watery, this; 希望 xīwàng hope; 希奇 xīqí rare, strange; 希腊 Xīlà Greece
衛|[wèi] 保卫 defend; 卫生 sanitary; 卫星 satellite
列|[liè] column, line up; 列车 lièchē train; 排列 páiliè arrange
圖|[tú] picture; 地图 dìtú map; 图书馆 túshūguǎn library
室|[shì] room; 教室 jiàoshì classroom; 卧室 wòshì bedroom; 办公室 bàngōngshì office
亂|[luàn] chaotic, disorderly, messy; 混乱 hùnluàn chaos
劉|[Liú] {family name}>
爺|[yé] father; 爷爷 yéye grandpa
龍|[lóng] dragon; 恐龙 kǒnglóng dinosaur
咱|[zán] (=咱们 zánmen) we = you and I<br /><br />[zan] (abbreviation for 早晚 zǎowǎn) all the time, morning and evening, sooner or later
章|[zhāng] chapter, seal, stamp, medal, badge, rules
席|[xí] mat, seat, banquet; 主席 zhǔxí chairperson
錯|[cuò] (=错误 cuòwù) mistake; 不错 búcuò not bad, pretty good; 一点儿不错! yìdiǎnr búcuò! perfectly correct!
兄|[xiōng] (elder) brother; 兄弟 xiōngdì brothers<br /><br />{Compare with 儿(F兄) ér child and 只 zhǐ only}
暗|[àn] (=黑暗 hēi'àn) dark; 暗暗 secretly; 阴暗 gloomy; 暗示 hint
創|[chuàng] 创造 chuàngzào create<br /><br />[chuāng] 创伤 chuāngshāng trauma
排|[pái] arrange, row, line<br /><br />[pǎi] 排子车 pǎizìchē handcart
春|[chūn] (=春天 chūntiān, =春季 chūnjì) spring; 春卷 chūnjuǎn spring roll; 春夏秋冬 chūnxiàqiūdōng the four seasons
须|[xū] (F須) (=必须 bìxū) must, (F鬚) (=胡须 húxū) beard
承|[chéng] 承认 chéngrèn admit; 继承 jìchéng inherit
案|[àn] desk, (law) case; 答案 dá'àn answer or solution to a problem
忙|[máng] hurry, busy; 帮忙 help; 连忙 right away
呼|[hū] shout, exhale; 呼吸 hūxī breathe; 欢呼 huānhū cheer
樹|[shù] tree; 树林 shùlín woods; 树木 shùmù trees; 树干 shùgàn trunk
痛|[tòng] painful; 痛苦 tòngkǔ suffering; 痛快 tòngkuai delighted
沉|[chén] to sink; 沉重 chénzhòng heavy<br /><br />[chēn] 黑沉沉 hēichēnchēn pitch-black
啊|[a] (used as phrase suffix, indicating obviousness/impatience)<br /><br />[ā] (indicating elation); 啊!我又赢了! ā! Wǒ yòu yíngle! Ha! I've won again!<br /><br />[á] (indicating doubt or questioning), huh?; 啊?你说什么? ?? Nǐ shuō shenme? Huh? What are you saying?<br /><br />[ǎ] (indicating puzzled surprise)<br /><br />[à] (indicating agreement/approval); 啊,好吧! ?, hǎoba! Well, OK!
靈|[líng] clever, spirit, soul, elf; 灵活 línghuó nimble, easy
職|[zhí] duty; 职工 zhígōng staff; 职业 zhíyè occupation
鄉|[xiāng] countryside, home town
細|[xì] thin; 仔细 zǐxì careful; 细胞 xìbāo cell; 详细 xiángxì detailed
訴|[sù] 告诉 gàosu tell; 诉讼 sùsòng lawsuit
態|[tài] form; 态度 tàidu manner; 状态 zhuàngtài state
停|[tíng] (=停止 tíngzhǐ) stop; 停车场 tíngchēchǎng parking lot
印|[yìn] (=印刷 yìnshuā) print, (=印章 yìnzhāng) seal
筆|[bǐ] writing implement; 毛笔 brush; 钢笔 pen; 铅笔 pencil
夏|[xià] (=夏天 xiàtiān) summer; 春夏秋冬 chūnxiàqiūdōng the four seasons
助|[zhù] (=帮助 bāngzhù) help
福|[fú] blessing, good fortune, (=幸福 xìngfú) happiness, happy; 祝福 zhùfú invoke/wish a blessing; 福建 Fújiàn<br /><br />{It is common to hang calligraphy of this character up-side-down on doors, in order to get people to note that 福倒了 fú dàole = "The 'Fu' is up-side-down", which is pronounced just as 福到了 = "Fortune/happiness has come"}
塊|[kuài] piece, lump, chunk, (=元 yuán) Chinese dollar
冷|[lěng] cold; 冷静 lěngjìng calm
球|[qiú] ball; 足球 zúqiú football (soccer); 地球 dìqiú the Earth
姑|[gū] 姑娘 gūniang girl
划|[huá] row (a boat) (F劃) scratch<br /><br />[huà] (F劃) (=计划 jìhuà) plan (F畫)
既|[jì] since, already; 既然 jìrán since, now that
質|[zhì] (=物质 wùzhì) matter, substance; 质量 zhìliàng quality, mass
巴|[bā] 尾巴 wěiba tail; 嘴巴 zuǐbā mouth; 巴西 Bāxī Brazil<br /><br />[bà] 嘴巴子 zuǐbàzi mouth, a slap in the face
致|[zhì] send, convey; 一致 yízhì identical, (F緻) 细致 xìzhì careful
灣|[wān] harbor; 台湾 Táiwān
演|[yǎn] (=表演 biǎoyǎn) perform, act, performance
木|[mù] tree, (=木头 mùtou) wood;<br /><br />{Compare with 本 běn root and 大 dà big}
韋|[wéi] soft leather, {family name}>
怪|[guài] blame, (=奇怪 qíguài) strange; 怪物 guàiwu monster
圍|[wéi] surround; 围棋 wéiqí Japanese "go"
靜|[jìng] still, quiet; 静电 jìngdiàn static electricity
旁|[páng] (=旁边 pángbiān) side<br /><br />[bàng] (=傍)
園|[yuán] (=花园 huāyuán) garden, (=公园 gōngyuán) park
否|[fǒu] not; 是否 shìfǒu whether or not, is (it) or is (it) not?<br /><br />[pǐ] bad, inferior; 臧否 zāngpǐ pass judgment (on people)
副|[fù] assist, vice-; 副词 fùcí adverb
輯|[jí] 编辑 biānjí edit; 逻辑 luójí {loan}> logic
采|[cǎi] pick, gather (F採)<br /><br />[cài] (F埰) 采地 càidì fief
食|[shí] eat, (=食物 shíwù, =食品 shípǐn) food<br /><br />[sì] feed
登|[dēng] climb
夠|[gòu] enough; 能够 nénggòu be capable of
賽|[sài] contest; 比赛 match, race
米|[mǐ] (=米饭 mǐfàn) rice, meter; 玉米 yùmǐ corn
假|[jiǎ] false<br /><br />[jià] (=假期 jiàqī) vacation
較|[jiào] relatively, quite; 比较 bǐjiào compare, relatively<br /><br />[jiǎo] (bǐjiǎo = bǐjiào)
姐|[jiě] (=姐姐 jiějie) older sister; 小姐 xiǎojie young lady
樓|[lóu] story, building; 大楼 mansion; 楼梯 lóutī stairs
获|[huò] (F獲) (=获得 huòdé) get, obtain, (F穫) 收获 shōuhuò harvest
孫|[sūn] grandchild; 子孙 zǐsūn children and grandchildren, descendants; 孙悟空 Sūn Wùkōng monkey with supernatural powers in the nobel "Journey to the West"; 孙中山 Sūn Zhōngshān = 孙逸仙 Sūn Yixiān = Sun Yat-sen, leader of the Republican Revolution and the KMT
宣|[xuān] (=宣布 xuānbù) declare; 宣传 propaganda
穿|[chuān] penetrate, wear
詩|[shī] poem; 诗人 shīrén poet
歌|[gē] song; 唱歌 chànggē to sing
速|[sù] fast; 速度 sùdù speed
忽|[hū] disregard, (=忽然 hūrán) suddenly, (=忽而 hū'ér) now...
堂|[táng] hall; 食堂 shítáng dining hall, canteen; 课堂 kètáng classroom<br /><br />[tāng] 亮堂堂 liàngtāngtāng brightly lit, brilliant
敵|[dí] (敌人 dírén) enemy; 敌军 enemy troops
試|[shì] try, test; 考试 kǎoshì test, quiz
謝|[xiè] thank; 谢谢 xièxie thanks; 非常感谢
央|[yāng] entreat, center; 中央 central; 央求 beg, plead
懷|[huái] bosom, cherish; 怀疑 huáiyí suspect; 怀念 huáiniàn cherish memory
顧|[gù] (=照顾 zhàogu) look after; 顾客 gùkè customer
驗|[yàn] (=经验 jīngyàn) experience
營|[yíng] camp; 营火 campfire; 营业 do business
止|[zhǐ] (=停止 tíngzhǐ) stop
姓|[xìng] family name; 姓名 xìngmíng full name (family name and personal name); 您贵姓 Nín guìxìng? (May I ask for) your family name, Sir/Madame?
養|[yǎng] raise, nourish; 营养 yíngyǎng nutrition
麗|[lì] 美丽 měilì beautiful; 壮丽 majestic<br /><br />[Lí] Korea<br /><br />{Compare with 朋 péng friend and 册 cè book}
屬|[shǔ] belong to, be subordinate to, born in a specific year acoording to the Chinese calendar<br /><br />[zhǔ] enjoin
景|[jǐng] scene, scenery; 风景 fēngjǐng scenery, landscape
郭|[guō] outer wall of city, {family name}>
依|[yī] (=依靠 yīkào) depend on, comply with, according to; 依然 yīrán still
威|[wēi] 威胁 wēixié threaten, imperil; 示威 shìwēi demonstrate; 挪威 Nuówēi Norway
按|[àn] press, (=按照 ànzhào) according to; 按摩 ànmó massage
惡|[è] evil<br /><br />[wù] (厌恶) hate<br /><br />[ě] (恶心) nauseous
慢|[màn] slow
座|[zuò] (=座位 zuòwèi) seat, place, stand, pedestal, base, {classifier for mountains, bridges etc.}>
罪|[zuì] crime, guilt
維|[wéi] 纤维 xiānwéi fiber; 维护 wéihù safeguard; 思维 síwéi think
漸|[jiàn] (=渐渐 jiànjiàn, =逐渐 zhújiàn) gradually<br /><br />[jiān] dip/soak in liquid
勝|[shèng] (=胜利 shènglì) victory, triumph, win
藏|[cáng] store; conceal, hide<br /><br />[zàng] (=西藏 Xīzàng) Tibet
皇|[huáng] 皇帝 huángdì emperor; 皇后 huánghòu empress
街|[jiē] street; 街道 street, neighborhood; 街头 street-corner
激|[jī] surge, dash, (=激动 jīdòng) excite; 激烈 jīliè intense
異|[yì] different; 异常 yìcháng unusual
摘|[zhāi] pick, take off, select
角|[jiǎo] horn, corner, dime<br /><br />[jué] actor, role
瞧|[qiáo] look
負|[fù] carry on shoulder, suffer, negative
施|[shī] carry out; 措施 cuòshī to measure, step; 施工 construction
模|[mó] 模范 mófàn model; 模仿 mófǎng imitate<br /><br />[mú] 模样 múyàng appearance; 模子 múzi mold, pattern, die
草|[cǎo] grass; 草莓 cǎoméi strawberry
某|[mǒu] certain, some; 某人 mǒurén somebody
銀|[yín] silver; 银行 yínháng bank
露|[lù] (=露水 lùshui) dew, show, reveal, betray<br /><br />[lòu] reveal
陣|[zhèn] battle array, {classifier for phases, spells etc.}>; 一阵风 yí zhèn fēng a short period of time
值|[zhí] (=值得 zhíde) be worth, (=价值 jiàzhí) value
班|[bān] class, work; 上班 shàngbān go to work; 值班 zhíbān be on duty
層|[céng] layer, level, storey
修|[xiū] repair, decorate; 修改 xiūgǎi revise
差|[chà] differ, wrong<br /><br />[chā] 差别 difference<br /><br />[chāi] 出差<br /><br />[cī] rank<br /><br />[cuō] stumble
味|[wèi] (=味道 wèidao) flavor, taste
織|[zhī] weave, knit; 组织 zǔshī organize; 纺织 fǎngzhī spin and weave
藥|[yào] medicine, drug
館|[guǎn] building; 饭馆 restaurant
密|[mì] thick, dense
亮|[liàng] bright, light, shine, loud and clear; 漂亮 piàoliang handsome, beautiful, remarkable, brilliant, smart
律|[lǜ] 法律 fǎlǜ law; 律师 lǜshū lawyer; 纪律 jìlǜ discipline; 旋律 xuánlǜ tune, melody
習|[xí] 练习 liànxí practice; 学习 xuéxí study; 习惯 xíguàn habit
田|[tián] field; 田野 tiányě open country
簡|[jiǎn] 简单 jiǎndān simple; 简体字 jiǎntǐzì simple form character
免|[miǎn] exempt; 避免 bìmiǎn avoid; 免费 miǎnfèi free
毒|[dú] (毒物) poison; (毒品) drug; 病毒 virus
歸|[guī] return
波|[bō] (=波浪 bōlàng) wave; 波长 bīchánga wavelength
型|[xíng] mould, type; 典型 diǎnxíng typical
屋|[wū] (屋子 wūzi) room, (=房屋 fángwū) building; 屋顶 roof
換|[huàn] change, exchange
救|[jiù] help, rescue; 救命 jiùmìng! Help! Save me!
寄|[jì] to mail; 寄生虫 jìshēngchóng parasite
帝|[dì] emperor; 帝国 dìguó empire; 上帝 Shàngdì God
退|[tuì] go backwards, (=后退 hòutuì) retreat; 撤退 chètuì withdraw
洋|[yáng] (=海洋 hǎiyáng) ocean; 太平洋 Tàipíng Yáng Pacific Ocean<br /><br />[yāng] 暖洋洋 nuǎnyāngyāng warm
絲|[sī] silk, thread
湖|[hú] lake; 湖泊 húpō lakes; 湖南 Húnán; 湖北 Húběi
睡|[shuì] (=睡觉 shuìjiào) sleep
勞|[láo] (=劳动 láodòng) labor<br /><br />[lào] encourage, console
婦|[fù] (=妇女 fùnǚ) woman; 夫妇 fūfù married couple
伯|[bó] eldest brother, uncle<br /><br />[bǎi] 大伯子 dàbǎizi eldest brother of one's husband<br /><br />[bai] 叔伯 shūbai cousinship on father's side<br /><br />[bà] (=霸)<br /><br />{Compare with 佰 bǎi hundred}
尼|[ní] 尼姑 Buddhist nun; 尼加拉瓜 Níjiālāguā Nicaragua; 尼龙 nílóng nylon
皮|[pí] (=皮肤 pífū) skin
祖|[zǔ] (祖先 zǔxiān) ancestor; 祖母 zǔmǔ grandmother
雄|[xióng] powerful, male; 英雄 yīngxióng hero; 雄伟 xióngwěi grand; 雄鸡 xióngjī rooster
婚|[hūn] (=结婚 jíehūn) marry; 婚礼 hūnlǐ wedding; 婚姻 hūnyīn marriage
康|[kāng] 健康 jiànkāng health; 康熙字典 Kāngxī Zìdiǎn dictionary compiled in the Kangzi period
評|[píng] criticize, comment, review
追|[zhuī] pursue
哈|[hā] exhale, sip, aha!, {the sound of laughter, etc.}><br /><br />[hǎ] {family name}><br /><br />[hà] 哈撒 hàsa shake, swing; 哈什蚂 hàshimǎ Chinese forest frog
絡|[luò] net, twine<br /><br />[lào] 挂络 guàlào involvement, implication
店|[diàn] (=商店 shāngdiàn) store, shop; 饭店 fàndiàn restaurant
翻|[fān] turn over; 翻译 fānyì translate
環|[huán] ring; 环境 huánjìng environment, surroundings
禮|[lǐ] ceremony; 婚礼 hūnlǐ wedding; 礼貌 lǐmào polite
跑|[pǎo] run<br /><br />[páo] paw the earth
超|[chāo] (=超过 chāoguò) go past, exceed, (=超级 chāojí) super
叶|[yè] (F葉) leaf (of a plant)<br /><br />[xié] harmonize
壓|[yā] press, pressure<br /><br />[yà] 压根 yàgēn from the start, in the first place, altogether, entirely, totally, at all, simply
占|[zhān] fortune telling<br /><br />[zhàn] occupy; 占领 zhànlǐng capture
均|[jūn] even; 平均 píngjūn average
永|[yǒng] (=永远 yǒngyuǎn) always, forever, eternal<br /><br />{Compare with 水 shuǐ water}
烈|[liè] (=强烈 qiángliè) intense; 热烈 ardent; 烈士 martyr
獎|[jiǎng] prize, award; 奖金 bonus; 奖学金 scholarship
婆|[pó] old lady; 老婆 lǎopo wife
趕|[gǎn] catch up
富|[fù] (=富有 fùyǒu) rich; 丰富 fēngfù abundant; 财富 cáifù wealth
蘭|[lán] 兰花 lánhuā orchid
錄|[lù] record; 记录 jìlù take notes; 录音机 tape recorder
畫|[huà] draw, picture
遇|[yù] meet; 遇到 yùdào encounter
頓|[dùn] to pause, meal
藝|[yì] skill, (=艺术 yìshù) art; 文艺 wényì literature and art
普|[pǔ] 普通 pǔtōng common; 普通话 Pǔtōnghuà Common Speach = Mandarin; 普遍 pǔbiàn universal
判|[pàn] judge; 批判 pīpàn criticize
源|[yuán] (=来源 láiyuán) source, origin; 资源 zīyuán resources
億|[yì] 100 million
素|[sù] plain, white, vegetarian; 因素 yīnsù factor, element
船|[chuán] boat, ship; 渡船 dùchuán ferry; 宇宙飞船 yǔzhòu fēichuán "cosmic flying boat" = spaceship
繼|[jì] (=继续 jìxù) continue; 继承 jìchéng inherit
尚|[shàng] esteem; 高尚 gāoshàng noble, lofty<br /><br />[shang] 和尚 héshang monk
嘴|[zuǐ] (嘴巴 zuǐba) mouth; 嘴唇 zuǐchún lip
察|[chá] 观察 guānchá observe; 警察 jǐngchá police
雨|[yǔ] rain; 雨水 rainwater; 暴风雨 bàofēngyǔ rainstorm
優|[yōu] excellent; 优良 fine; 优秀 outstanding; 优越 yōuyuè superior
您|[nín] {polite}> you; 您贵姓 Nín guìxìng? (May I ask for) your family name, Sir/Madame?
險|[xiǎn] (危险 wēixiǎn) danger; 保险 bǎoxiǎn insurance
烟|[yān] (F煙) smoke, cigarette, mist<br /><br />[yīn] (=氤)
階|[jiē] (=台阶) steps; 阶级 class; 军阶 rank; 阶段 phase
擔|[dān] carry on a shoulder pole<br /><br />[dàn] two buckets full, 50 kg.
散|[sàn] break up, distribute, dispel<br /><br />[sǎn] fall apart, scattered
板|[bǎn] board, hard, (F闆) 老板 lǎobǎn shopkeeper, proprietor, boss
钟|[zhōng] (F鐘) bell, clock; 三点钟 3 o'clock, (F鍾) 钟爱 zhōng'ài dote on, {family name}>
訪|[fǎng] (=访问 fǎngwèn) visit; 采访 gather material
妹|[mèi] (妹妹 mèimei) little sister; 姐妹 jiěmèi sisters<br /><br />{Compare with 妺 mò = wife of the last ruler of the Xia dynasty}
伸|[shēn] stretch
佛|[Fó] Buddha; 佛教 Fójiào Buddhism<br /><br />[fú] 仿佛 fǎngfú seem
限|[xiàn] limit, bounds; 有限 limited; 限制 restrict
討|[tǎo] (=讨论 tǎolùn) discuss; 讨厌 tǎoyàn digusting<br /><br />{讨口彩 tǎokǒucǎi = 讨个吉利(话) tǎo ge jílì(huà) to ask for something as a token of good omen}
臨|[lín] overlook, be adjacent to; 临时 temporary
吳|[Wú] {family name}>, Wu Kingdom (222-280 A.D.)
搖|[yáo] shake
跳|[tiào] jump; 跳伞 tiàosǎn parachute; 跳舞 tiàowǔ dance
曲|[qū] (=弯曲 wānqū) curved<br /><br />[qǔ] melody
練|[liàn] white silk, (=练习 liànxí) practice
構|[gòu] 结构 jiégòu structure; 构成 constitute; 构造
玩|[wán] play; 玩具 wánjù toy; 好玩儿 hǎowánr fun
玉|[yù] (玉石 yùshí) jade; 玉米 yùmǐ corn<br /><br />{Compare with 王 wáng king}
犯|[fàn] violate; 犯罪 fànzuì commit a crime; 罪犯 criminal
廠|[chǎng] (=工厂 gōngchǎng) factory
肯|[kěn] be willing to, consent; 肯定 kěndìng definitely
協|[xié] 协作 xiézuò cooperate
幸|[xìng] good fortune, luck; 幸福 xìngfú happy
揮|[huī] wave, wield; command an army; 挥手 wave (one's hand)
效|[xiào] (=效果 xiàoguǒ) effect, result; 有效 yǒuxiào effective
齊|[qí] 整齐 zhěngqí neat; 一齐 yìqí together<br /><br />[zhāi] (=斋)<br /><br />[zī] (=粢)
封|[fēng] to seal; 封建 feudal; 信封 envelope
溫|[wēn] (=温暖 wēnnuǎn) warm; 温度 wēndù temperature
疑|[yí] (怀疑 huáiyí) doubt, suspect; 迟疑 chíyí hesitate
肉|[ròu] flesh, meat; 肌肉 jīròu muscle<br /><br />{Compare with 内 nèi inside}
攻|[gōng] (=进攻 jìngōng, =攻击 gōngjī) attack; 专攻 specialize in studying
紙|[zhǐ] paper; 报纸 bàozhǐ newspaper
策|[cè] plan; 政策 zhèngcè policy
充|[chōng] fill; 充分 chōngfèn full, ample; 充满 chōngmǎn full of
頂|[dǐng] top, {classifier for hats etc.}>; 一顶帽子 yì dǐng màozi a hat
尋|[xún] (=寻找 xúnzhǎo) seek<br /><br />[xín] 寻思 xínsi
寧|[nìng] (=宁愿 nìngyuàn, 宁可 jìngkě) prefer, rather<br /><br />[níng] 宁静 tranquil
沙|[shā] sand; 沙漠 shāmò desert; 沙丘 shāqiū dune; 沙发 shāfā {loan}> sofa
防|[fáng] embankment, guard, protect, anti-
抓|[zhuā] grab, seize, arrest, attract, scratch
例|[lì] (=例子 lìzi) example; 例如 lìrú for instance
股|[gǔ] thigh, section
賣|[mài] sell; 苹果怎么卖? Píngguǒ zěnme mài? How much are the apples?
順|[shùn] along, in the same direction as, obey, suitable
警|[jǐng] 警察 jǐngchá police; 警告 jǐnggào warn
夢|[mèng] dream
劇|[jù] drama, play, opera; 剧烈 jùliè severe
善|[shàn] good; 改善 gǎishàn improve; 善于 be good at
蒙|[méng] to cover, ignorant<br /><br />[mēng] cheat<br /><br />[Měng] 蒙古 Měnggǔ Mongolia
票|[piào] ticket
良|[liáng] (优良 yōuliáng, 良好) good; 良心 liángxīn conscience
范|[fàn] {family name}>; (F範) 范围 fànwéi scope, range; 模范 mófàn model, fine example
堅|[jiān] hard, solid, firmly; 坚持 persist; 坚定 firm
端|[duān] hold sth. level with both hands, extremity, end
靠|[kào] lean on, rely on, keep close to, come up to, near
雜|[zá] mixed; 复杂 fùzá complicated; 杂志 zázhì magazine<br /><br />[zā] 拉里拉杂 lālilāzā rambling
貴|[guì] expensive, valuable
怒|[nù] anger, rage
稿|[gǎo] stalk of grain, draft, sketch, manuscript
拍|[pāi] clap, paddle; 乒乓拍 pīngpāngpāi ping-pong paddle
率|[lǜ] rate, proportion; 频率 pínlǜ frequency<br /><br />[shuài] 率领 shuàilǐng lead, command
舊|[jiù] old (not new) (compare with 老 lǎo old, not young; 新 xīn new)
掉|[diào] drop, fall
啦|[la] corresponding to 了 le plus 啊 a, {interjection indicating excitement/doubt}><br /><br />[lā] 呼啦啦 hūlālā flapping sound<br /><br />[lá] 啦啦 lálá chat, gossip, jaw; 啦呱 láguā chat, gossip
莫|[mò] nothing; not; 莫大 mòdà greatest; 莫名其妙 mòmíngqímiào baffling, inexplicable
授|[shòu] award, give; teach; 教授 jiàoshòu professor
守|[shǒu] guard; 保守 bǎoshǒu conservative
油|[yóu] oil; 汽油 qìyóu gasoline; 酱油 jiàngyóu soy sauce<br /><br />[yōu] 绿油油 lǜyōuyōu bright/fresh green; 碧油油 bìyōuyōu bluish green
恩|[ēn] kindness; 周恩来 Zhōu ēnlái
積|[jī] accumulate; 积极 jījí positive; 面积 area
益|[yì] (=利益 lìyì) advantage, profìt
縣|[xiàn] county; 县长 xiànzhǎng county magistrate
哭|[kū] cry, weep
罷|[bà] stop; 罢工 strike; 罢了 bàle that's all<br /><br />[pí] (=疲) tired, weary, exhausted
庭|[tíng] 家庭 jiātíng family; 法庭 court; 庭院 courtyard
窗|[chuāng] (=窗户 chuānghu, =窗口 chuāngkǒu) window; 窗帘 curtain
揚|[yáng] raise; 发扬 fāyáng develop, promote
忘|[wàng] (=忘记 wàngjì) forget<br /><br />[wáng] 忘八
午|[wǔ] 中午 noon; 上午 morning; 下午 afternoon; 午饭 lunch<br /><br />{Compare with 牛 niú cow}
卡|[kǎ] block, calory, card<br /><br />[qiǎ] checkpoint
雪|[xuě] snow; 雪花 xuěhuā snowflake; 滑雪 huáxuě to ski
菜|[cài] vegetable, dish
牌|[pái] tablet, brand, cards, dominoes; 牌子 páizi sign, label, logo
牛|[niú] ox, cow, bull; 牛奶 niúnǎi milk<br /><br />{Compare with 午 wǔ noon}
脫|[tuō] take off; 脱离 tuōlí break away
博|[bó] abundant, plentiful; 博士 Ph.D.; 博爱 universal love; 博物馆 bóqùguǎn museum
丈|[zhàng] 10 chǐ = 3 1/3 meters, to measure land, male elder relative/person; 丈夫 zhàngfu husband
彈|[dàn] 炸弹 bomb; 子弹 bullet<br /><br />[tán] 弹吉他 play guitar
洲|[zhōu] continent; 亚洲 Yàzhōu Asia; 欧洲 ōuzhōu Europe; 非洲 Fēizhōu Africa
松|[sōng] pine tree; 松鼠 squirrel, (F鬆) loose
坏|[huài] (F壞) bad<br /><br />[pī] (=坯)
鄧|[Dèng] {family name}>
鮮|[xiān] fresh<br /><br />[xiǎn] few, rare; 朝鲜 Korea
短|[duǎn] short (opposite of 长 cháng)
畢|[bì] 毕业 bìyè graduate; 毕竟 bìjìng after all
置|[zhì] put, place; 位置 wèizhi position
楚|[chu] 清楚 qīngchu clear<br /><br />[chǔ] 苦楚 kǔchǔ misery
歐|[ōu] 欧洲 ōuzhōu Europe; 欧姆 ōumǔ ohm
略|[lüè] brief, slight; 略微 lüèwēi slightly
智|[zhì] 智慧 zhìhuì wisdom; 智力 zhìlì intellegence
島|[dǎo] island
抗|[kàng] (=抵抗 dǐkàng) resist; 反抗 revolt; 抗议 protest
妻|[qī] (=妻子 qīzi) wife
抱|[bào] hug, embrace
載|[zài] carry, be loaded with<br /><br />[zǎi] 记载 put down in writing
敗|[bài] (失败 shībài) lose, be defeated; 腐败 fǔbài corrupt
槍|[qiāng] gun<br /><br />[chēng] 欃枪 chánchēng comet
適|[shì] 合适 héshì suitable, appropriate<br /><br />[dí] 适从 dícóng follow, go to
虛|[xū] empty, void; 谦虚 qiānxū modest; 虚心 xūxīn open-minded; 空虚 kōngxū hollow
預|[yù] 预备 prepare; 预先 beforehand; 预报 forecast
睛|[jīng] eye<br /><br />[jing] 眼睛 yǎnjing eye
刺|[cì] thorn, prick, stab, irritate, (=刺杀 cìshā) assassinate<br /><br />[cī] wham
爹|[diē] dad; 爹爹 diēdie daddy; 爹地 diēdì daddy
紛|[fēn] 纷纷 one after another; 纠纷 jiūfēn dispute; 纷乱
介|[jiè] 介绍 jièshào introduce; 介词 preposition
括|[kuò] 包括 bāokuò include; 概括 gàikuò generalize
銷|[xiāo] melt (metal), remove, sell; 脱销 sold out
降|[jiàng] fall, descend<br /><br />[xiáng] 投降 tóuxiáng surrender
魚|[yú] fish; 金鱼 jīnyú goldfish; 鲨鱼 shāyú shark
奔|[bēn] run fast, flee<br /><br />[bèn] go straight towards
忍|[rěn] endure, tolerate; 忍不住 rénbuzhù can't bear, can't resist
宗|[zōng] ancestor, clan, faction; 宗教 religion; 祖宗 ancestry
盤|[pán] disk, tray; 算盘 suànpán abacus; 棋盘 chessboard
耳|[ěr] (=耳朵 ěrduo) ear; 耳机 earphone, headphones
野|[yě] wild
訊|[xùn] interrogate; 通讯 tōngxùn news report
配|[pèi] match, deserve; 分配 distribute; 配合 pèihé cooperate
禁|[jìn] (禁止 jìnzhǐ) prohibit<br /><br />[jīn] endure; 不禁 bùjīn can't resist (doing something)
索|[suǒ] rope; 思索 sīsuǒ think deeply; 索性 suǒxìng simply, just
趙|[Zhào] {family name}>
默|[mò] silent; 默默 mòmò silently; 沉默 chénmò reticent; 幽默 yōumò humor
徒|[tú] on foot, follower; 徒弟 túdi apprentice; 匪徒 fěitú gangster
架|[jià] frame, rack, shelf, put up, {classifier for planes, radios etc.}>; 一架飞机 yí jià fēijī an aeroplane; 书架 shūjià bookshelf
燈|[dēng] lamp
峰|[fēng] mountain peak
狀|[zhuàng] (=状态 zhuàngtài, =状况 zhuàngkuàng) condition, state of affairs
款|[kuǎn] fund
移|[yí] (=移动 yídòng) move; 转移 shift, transform; 移植 transplant
爸|[bà] dad; 爸爸 bàba daddy
托|[tuō] hold in the palm, rely on; 委托 wěituō entrust
洪|[hóng] (=洪水 hóngshuǐ) flood, vast, {family name}>; 洪亮 hóngliàng loud and clear, magnanimity
升|[shēng] liter, rise, ascend
伙|[huǒ] {classifier for groups, crowds, bands etc.}>, group of people. (=伙伴 huǒbàn) partner; 家伙 jiāhuo fellow
訂|[dìng] conclude (compare with 定 dìng decide)
毫|[háo] long fine hair, milli-; 毫不 háobù not at all
狐|[hú] 狐狸 húli fox
鎮|[zhèn] town, press down, calm, cool
床|[chuáng] bed; 床单 chuángdān sheet; 河床 river bed
互|[hù] 互相 hùxiāng each other; 相互 xiānghù mutually, reciprocal
套|[tào] set, cover; 手套 glove; 一套衣服 yí tào yīfu a (full) suit (of clothing)
旅|[lǚ] (=旅行 lǚxíng) travel; 旅馆 lǚguǎn inn; 旅行社 lǚxíngshè travel agency
逃|[táo] (逃跑 táopǎo) escape, flee
罵|[mà] curse; 妈妈骂马吗? Māma mà mǎ ma? Does mama curse the horse?
輸|[shū] transport, lose (compare with 赢 yíng win)
唱|[chàng] sing; 唱歌
靖|[jìng] 绥靖 suíjìng pacify, appease
秘|[mì] 秘密 mìmì secret; 秘书 secretary<br /><br />[bì] 秘鲁 Peru
詞|[cí] word; 词典 cídiǎn dictionary; 动词 dòngxí verb; 词汇 cíhuì vocabulary
困|[kùn] (=困难 kùnnán) difficult, (F睏) tired
淚|[lèi] (眼泪, 泪水) tear; 泪珠 teardrop
熟|[shú] cooked, ripe, familiar; 熟悉 shúxī know well<br /><br />[shóu] {colloquial variant}>
財|[cái] wealth; 发财 fācài get rich
鬼|[guǐ] ghost; (魔鬼 móguǐ) devil; 鬼子 guǐzi foreign devil
骨|[gǔ] (骨头 gǔtou) bone<br /><br />[gū] 骨碌 gūlu roll
申|[shēn] explain<br /><br />{Compare with 甲 jiǎ helmet and 由 yóu from}
欲|[yù] desire, wish; 欲望 yùwàng desire, lust
征|[zhēng] journey; 长征 The Long March, attack, (F徵) evidence, levy
私|[sī] (私人) personal, (=私有 sīyǒu) privately owned, be private, (=自私 zìsī) selfish
舞|[wǔ] (跳舞 tiàowǔ) dance
秋|[qiū] autumn, fall; 春夏秋冬 chūnxiàiūdōng the four seasons
巨|[jù] (=巨大 jùdà) huge, gigantic
迎|[yíng] (欢迎 huānyíng) welcome
秀|[xiù] 优秀 yōuxiù excellent; 秀才 xiùcai scholar
搞|[gǎo] do
丁|[dīng] 4th in a series, cubes (in food preparation), {family name}><br /><br />[zhēng] 丁丁 zhēngzhēng clang, clank
吸|[xī] inhale; 呼吸 hūxī breathe; 吸收 xīshōu absorb; 吸引 xīyǐn attract
審|[shěn] 审判 shěnpàn bring to trial; 审问 interrogate
遍|[biàn] all over, everywhere; 普遍 universal, {classifier for repetitive times/occurrences}>; 再说一遍! Zài shuō yí biàn! Say (it) once more!
牆|[qiáng] (=墙壁 qiángbì) wall
朱|[zhū] vermilion, bright red
聖|[shèng] holy; 圣人 sage, saint; 圣诞节 Shèngdànjié Christmas
避|[bì] (避免 bìmiǎn) avoid; 逃避 táobì escape, evade
躍|[yuè] leap
忌|[jì] envy, avoid, quit; 忌讳 jìhui taboo
桌|[zhuō] table; 一张桌子 yì zhāng zhuōzi one table
執|[zhí] hold in hand; 执行 zhíxíng carry out
悲|[bēi] 悲哀 grieved; 悲观 pessimistic; 悲剧 tragedy
域|[yù] (math:) field; 领域 territory; 流域 valley; 区域 region
曉|[xiǎo] dawn; (晓得 xiǎode) know
弄|[nòng] do; 弄臣 nòngchén court jester<br /><br />[lòng] 里弄 alley
亡|[wáng] flee, lose, die
橋|[qiáo] bridge
輩|[bèi] generation; 先辈 older generation, ancestors
閃|[shǎn] (闪开) get out of the way, flash; 闪电 lightning
隱|[yǐn] hidden; 隐约 yǐnyuē faint, indistinct
勁|[jìn] strength, energy, spirit<br /><br />[jìng] 强劲
鬧|[nào] (热闹) noisy; 闹钟 alarm clock
恐|[kǒng] (=恐怕 kǒngpà) I'm afraid; 恐怖 kǒngbù terror
呀|[ya] {sentence final particle like 啊 a}><br /><br />[yā] ah, oh
付|[fù] pay
敬|[jìng] (尊敬 zūnjìng) respect
監|[jiān] 监狱 prison; 监督 supervise<br /><br />[jiàn] eunuch
廳|[tīng] hall; 餐厅 cāntīng dining room
庫|[kù] warehouse; 数据库 shùjùkù database
震|[zhèn] shake, shock; 地震 earthquake
材|[cái] (=材料 cáiliào) material; 教材 jiàocái teaching material
冰|[bīng] ice; 冰箱 bīngxiāng refrigerator; 冰凉 bīngliáng ice-cold; 冰岛 Bīngdǎo Iceland; 冰淇淋 bīngqilín icecream
醒|[xǐng] become sober, wake up; 提醒 remind
慶|[qìng] 庆祝 qìngzhù celebrate; 庆贺 qìnghè congratulate; 庆幸 qìngxìng rejoice
綠|[lǜ] (绿色 lǜsè) green<br /><br />[lù] (in some place names)
腿|[tuǐ] leg; 腿脚 ability to walk; 腿腕子 ankle; 大腿 thigh
述|[shù] state, narrate; 描述 describe; 上述 above-mentioned
徐|[xú] slowly, gently, {family name}>
尊|[zūn] (尊重, 尊敬) respect
硬|[yìng] hard; 硬件 yìngjiàn hardware
額|[é] (前额) forehead; 定额 quota
誤|[wù] (=错误 cuòwù) mistake
借|[jiè] borrow, lend
納|[nà] receive, accept, enjoy, pay, sew
折|[zhé] fold; break; change direction<br /><br />[shé] break<br /><br />[zhē] turn over
售|[shòu] sell; 售货 sell goods
遺|[yí] 遗传 yíchuán inherit; 遗憾 yíhàn regret<br /><br />[wèi] give
暴|[bào] violent, sudden; 暴露 expose<br /><br />[pù] (=曝)
缺|[quē] (缺乏quēfá) lack, be short of; 缺点 quēdiǎn shortcoming
迷|[mí] be lost; 我迷了路 Wǒ míle lù I am lost; 迷信 míxìn superstition, blind faith/worship
魯|[lǔ] {family name}>; (鲁莽 lǔmǎng) rude; dull
探|[tàn] (=探索 tànsuǒ) explore
貨|[huò] (=货物 huòwù) goods; 货币 huòbì money, currency
童|[tóng] 儿童 értóng children
緩|[huǎn] (缓慢 huǎnmàn) slow
偉|[wěi] (伟大) great, mighty; 宏伟 hóngwěi, 雄伟 xióngwěi grand
君|[jūn] (=君主 jīnzhǔ) monarch, sovereign, (=君子 jūnzǐ) gentleman; 暴君 tyrant
莊|[zhuāng] village; 庄稼 zhuāngjia crops; 庄严 solemn
凡|[fán] ordinary; (凡是 fánshì) every; 非凡 extraordinary
危|[wēi] 危险 dangerous; 危机 crisis; 危害 endanger
燒|[shāo] roast, cook, burn (compare with 炒 chǎo stir-fry)
彩|[cǎi] (色彩 sècǎi) colour; 彩色 cǎisè multicolour
搶|[qiǎng] rob; snatch; scrape<br /><br />[qiāng] 呼天抢地
控|[kòng] (控诉 kòngsù) accuse, (=控制 kòngzhì) control
胸|[xiōng] (胸膛, 胸脯) chest; (胸怀) heart, mind
戲|[xì] (戏剧 xìjù) drama, play; 游戏 yóuxì game
篇|[piān] sheet of paper, piece of writing
趣|[qù] interest, fun; 兴趣 interest; 趣味 interest, taste
束|[shù] bundle; 束缚 shùfù tie up; 结束 jiéshù finish
謂|[wèi] call; 所谓 so-called
概|[gài] 大概 roughly, most likely; 概念 concept; 气概 spirit
射|[shè] shoot, fire, send out; 注射 inject; 射箭 archery
課|[kè] lesson; 课本 kèběn textbook
洞|[dòng] hole, cave
麻|[má] hemp, (=芝麻 zhīma) sesame; 麻烦 máfan bother<br /><br />[mā] 麻麻黑 māmahēi dusk; 乱麻麻 luànmāmā messy, disorderly
杯|[bēi] cup; 干杯 gānbēi cheers
透|[tòu] penetrate, thorough; 透镜 tòujìng lens; 透明 transparent
郵|[yóu] 邮局 yóujú post office; 邮票 yóupiào stamp
榮|[róng] (=光荣 guāngróng, =荣誉 róngyù) glory, honor
懂|[dǒng] understand
擁|[yōng] embrace, crowd; 拥护 yōnghù support; 拥挤 yōngjǐ crowded
獻|[xiàn] donate; 贡献 gòngxiàn contribution
洗|[xǐ] wash; 洗澡 xǐzǎo bath, shower<br /><br />[Xiǎn] {family name}>
休|[xiū] stop, (=休息 xiūxi) rest; 退休 retire; 休养所 rest home
迫|[pò] compel; 压迫 yāpò oppress; 被迫 bèipò be compelled<br /><br />[pǎi] 迫击炮 pǎijīpào mortar
嘆|[tàn] sigh
狗|[gǒu] dog; 猎狗 liègǒu hound; 疯狗 fēnggǒu mad dog
偷|[tōu] steal; 小偷 xiǎotōu thief
陰|[yīn] opposite of 阳 yáng; 阴沉, 阴天 cloudy; 阴暗 gloomy
汽|[qì] vapor, steam; 汽由 qìyóu gasoline; 汽车 qìchē car
拜|[bài] honor, worship; 礼拜 lǐbài week<br /><br />[bái] 拜拜 báibai bye-bye
橫|[héng] horizontal<br /><br />[hèng] perverse
鼓|[gǔ] beat, play, drum, arouse<br /><br />[gū] 胖鼓鼓 pànggūgū fat, plump, full, bulging
健|[jiàn] 健康 jiànkāng health
厚|[hòu] thick, deep, kind, rich (food) (compare with 薄 báo thin)
簽|[qiān] 签订 qiāndìng conclude and sign (treaty, etc); 签名 qiānmíng signature
丹|[dān] cinnabar, red; 丹田 dāntián pubic region; 丹麦 Dānmài Denmark
洛|[Luò] name of a river in 河南 Hénán and 陕西 Shǎnxī
喊|[hǎn] (=喊叫 hǎnjiào, 呼喊 hūhǎn, 叫喊 jiàohǎn) shout, cry out
蓉|[róng] (=城都 Chéngdū); 芙蓉 fúróng lotus, cottonrose hibiscus
輪|[lún] wheel
岸|[àn] shore
奶|[nǎi] breasts, milk
淡|[dàn] thin, light; 淡蓝 dànlán (= 浅蓝 qiǎnlán) light blue
潮|[cháo] tide; (=潮湿 cháoshī) moist; 高潮 gāocháo climax
訓|[xùn] lesson
圓|[yuán] round, circle; (sometimes used for 元 yuán dollar)
卷|[juǎn] roll; 春卷 spring roll (F捲)<br /><br />[juàn] volume, book, exam paper<br /><br />[quán] (=鬈 quán) curly hair
釋|[shì] 解释 jiěshì explain; 释放 shìfàng release
諸|[zhū] all, various, {family name}>
妙|[miào] wonderful, subtle; 莫名其妙 mòmíngqímiào be baffled
唯|[wéi] 唯物主义 wéiwùzhǔyì materialism<br /><br />[wěi] {expressing acceptance of a request/command}>
奪|[duó] force one's way; 夺取 seize, capture; 争夺 fight for
逐|[zhú] expel, pursue, one by one; 逐渐 gradually; 逐步 step by step
燕|[yàn] (=燕子 yànzi) swallow (bird)<br /><br />[Yān] {family name}>
呆|[dāi] stupid, silly, foolish, stay; 呆板 dāibǎn stiff<br /><br />[ái] 呆板 áibǎn stiff
測|[cè] (测量 cèliáng) survey, measure; 观测 guāncè observe
浪|[làng] (=波浪 bōlàng) wave (of water); 浪费 waste
抽|[chōu] take out; shrink; whip; 抽烟 smoke tobacco
蓋|[gài] cover, shell; 盖子 lid
偏|[piān] slanting, leaning; stubbornly; unfortunately
閱|[yuè] experience, pass through, review; (阅读 yuèdú) read
購|[gòu] (购买 gòumǎi) purchase
途|[tú] way, route; 前途 prospect; 途经 via
縱|[zòng] longitudinally; 操纵 cāozòng operate; 纵对 zòngduì column, file
耶|[yé] {archaic interrogative particle}>, (=爷 yé) grandfather<br /><br />[Yē] 耶稣 Yēsū Jesus
摸|[mō] feel, stroke; 摸索 mōsuo grope; 捉摸 zhuōmō fathom
掛|[guà] hang, put up
航|[háng] sail, fly; 航行 hángxíng navigate; 航空 aviation
擇|[zé] (=选择 xuǎnzé) choose<br /><br />[zhái] choose
恨|[hèn] hate
舍|[shè] 宿舍 sùshè dormitory<br /><br />[shě] (F捨) give up, abandon; 舍不得 shěbùdé be loathe to leave at home
拳|[quán] box (with fists); 太极拳 tàijíquán Taiji shadowboxing
竹|[zhú] bamboo
唐|[táng] {family name}>, Tang Dynasty, boastfull, exaggerated; (唐突 tángtū) rude
譽|[yù] praise; 荣誉 róngyù honor; 名誉 míngyù fame
乘|[chéng] ride (a vehicle); multiply<br /><br />[shèng] chariot
弱|[ruò] weak; 微弱 wēiruò faint; 软弱 ruǎnruò feeble
檢|[jiǎn] (=检查 jiǎnchá) inspect
宮|[gōng] palace, temple, {family name}>; 子宫 zǐgōng womb
儀|[yí] ceremony, rite, gift, (=仪表 yíbiǎo) appearance, bearing, (=仪器 yíqì) instrument, apparatus
旗|[qí] flag
含|[hán] keep in mouth, contain
袁|[Yuán] {family name}>
址|[zhǐ] foundation of a building; 地址 dìzhǐ address
擺|[bǎi] put, arrange, sway, wave; 摇摆舞 yáobǎiwǔ "shake-sway-dance", waggle dance (of bees), rock 'n' roll
奧|[ào] 奥秘 àomì secret, mystery; 奥妙 àomiào profound, secret
番|[fān] {classifier for kinds, times, occurrences etc.}>; 番茄 fānqié tomato<br /><br />[Pān] 番禺 Pānyú county in Guǎngdōng
混|[hùn] mix up; 混乱 hùnluàn chaos<br /><br />[hún] muddy, muddled
滅|[miè] extinguish; 消灭 eliminate; perish; 歼灭 annihilate
握|[wò] hold, grasp; 掌握 comprehend
牙|[yá] (=牙齿 yáchǐ) tooth
慮|[lǜ] (考虑 kǎolǜ) consider; 忧虑 yōulǜ worry about
召|[zhào] 召开 zhàokāi convene
猛|[měng] fierce
寬|[kuān] wide, broad, extend, relax
盛|[chéng] fill; contain<br /><br />[shèng] flourishing; 茂盛 luxuriant
核|[hé] pit, nucleus; 核桃 hétao walnut<br /><br />[hú] 核儿 húr {colloquial}> pit
袋|[dài] bag, pocket
紹|[shào] 介绍 jièshào introduce
補|[bǔ] mend
典|[diǎn] 典型 diǎnxíng typical; 古典 classical; 词典 dictionary
圈|[quān] circle<br /><br />[juàn] pen, sty<br /><br />[juān] shut up in a pen
丰|[fēng] good-looking (F豐) 丰富 fēngfù abundant
雅|[yǎ] 文雅 wényǎ cultured, refined; 雅致 yǎzhi elegant<br /><br />[yā] 鸦片 yāpiàn opium
吉|[jí] lucky, auspicious
贊|[zàn] 赞成 approve of; 称赞 praise
茶|[chá] tea; 茶叶 cháyè tea leaves; 红茶 hóngchá "red tea" = black tea
亦|[yì] also; 反之亦然 fǎnzhīyìrán and vice-versa
谷|[gǔ] (山谷) valley; (F穀) (=谷物 gǔwù) grain; 谷子 gǔzi millet
穩|[wěn] (稳定 wěndìng) stable, steady; 稳当 wěndang reliable
汇|[huì] (F彙) gather together; 汇报 guìbào to report; 词汇 cíhuì vocabulary; (F匯) converge, remit
厲|[lì] 厉害 lìhai terrible, formidable, {family name}><br /><br />[lài] name of an ancient country<br /><br />{Compare with 历 lì experience}
屆|[jiè] to fall due, {classifier for year of graduation, regular sessions, meetings, etc.}>
跡|[jì] (=痕迹 hénjì) mark, trace, vestige; 奇迹 qíjì miracle
雷|[léi] thunder; 雷雨 thunderstorm; 雷达 radar
序|[xù] 秩序 zhìxu order; 程序 procedure; 次序 order
寒|[hán] (寒冷) cold
附|[fù] enclose, attach; 附近 fùjìn vicinity, nearby
雞|[jī] chicken; 宫保鸡丁 gōngbǎo jīdīng spicy diced chicken
遭|[zāo] meet with disaster
挑|[tiāo] (挑选) choose<br /><br />[tiǎo] poke; 挑战 challenge<br /><br />[tāo] 挑达 tāotà walk casually to and fro
肩|[jiān] (肩膀 jiānbǎng) shoulder; (肩负 jiānfù) take on
憶|[yì] (记忆 jìyì, 回忆 huíyì) remember, recall; memory
柔|[róu] yielding; 柔软 róuruǎn soft; 柔和 róuhe gentle
戴|[dài] put on; 戴眼镜 dài yǎnjìng wear glasses; 戴上帽子 dàishang màozi put on a hat
惜|[xī] (珍惜) cherish; 可惜 kěxī it's too bad; 不惜 bùxī not hesitate
隔|[gé] separate, stand between; 隔壁 next door
豪|[háo] (=毫不 hǎobù, =好不 hǎobù) not at all
誠|[chéng] (诚实) honest
瑞|[ruì] auspicious, good omen; 瑞雪 timely snow
減|[jiǎn] subtract; 减少 jiǎnshǎo decrease
播|[bō] sow, seed; 广播 broadcast; 传播 disseminate
麼|[me] (S么)<br /><br />[mó] 麽(F麼) 幺麽 yāomó petty, insignificant
針|[zhēn] needle; 方针 policy; 针刺 zhēncì acupuncture
棋|[qí] board game; 象棋 chess; 围棋 Go; 跳棋 Checkers
競|[jìng] 竞争 jìngzhēng compete; 竞赛 contest
臂|[bì] (手臂 shǒubì) arm<br /><br />[bei] 胳臂 gēbei arm
挺|[tǐng] quite, very; endure, stand; 挺立 stand upright
操|[cāo] conduct, grasp; 操纵 cāozòng operate<br /><br />[cào] make trouble
腰|[yāo] waist
狂|[kuáng] (疯狂 fēngkuáng) crazy
替|[tì] in place of; (代替 dàitì) replace, substitute
梅|[méi] plum, prune; 梅花 plum blossom; 梅林 plum grove
固|[gù] 巩固 gǒnggù consolidate; 固定 gùdìng fixed
倫|[lún] 伦理 lúnlǐ ethics
宋|[Sòng] the Song dynasty (960-1279); 宋体字 Sòng tǐzì "Song"-typeface
鋼|[gāng] steel; 钢笔 fountain pen; 钢琴 piano<br /><br />[gàng] sharpen
諾|[nuò] 诺言 nuòyán a promise
殘|[cán] injure, barbarous, incomplete, remnant
延|[yán] (延长 yáncháng) prolong
虎|[hǔ] (老虎 lǎohǔ) tiger<br /><br />[hū] 马马虎虎 mǎmahūhū<br /><br />[hù] 虎不拉 hùbulǎ {zool.}> shrike
迅|[xùn] 迅速 xùnsù rapid, swift
災|[zāi] (灾难 zāinàn, 灾害 zāihài) disaster
悄|[qiāo] 悄悄 qiāoqiāo quietly<br /><br />[qiǎo] 悄声 qiǎoshēng quietly
岳|[yuè] high mountain, wife's parents, {family name}>
喬|[qiáo] {family name}>; 乔木 qiáomù arbor
川|[chuān] river; 四川省 Sìchānshěng Sichuan Province; 冰川 bīngchuān glacier
仇|[chóu] revenge, hatered, {family name}>; 报仇 bàochóu get revenge<br /><br />[qiú] mate, {family name}>
季|[jì] (=季节 jìjié) season; 冬季 dōngjì winter; 四季 sìjì four seasons
吹|[chuī] blow
糧|[liáng] (粮食 liángshi) grain, food
聚|[jù] gather, get together; 核聚变 héjùbiàn nuclear fusion
譯|[yì] (翻译 fānyì) translate
珠|[zhū] (珠子 zhūzi) pearl, bead; 眼珠子 eyeball; 泪珠 teardrop
叔|[shū] (=叔叔 shūshu) uncle, father's younger brother
謀|[móu] scheme; 阴谋 conspiracy
礎|[chǔ] 基础 jīchǔ foundation, base, basis; 础石 chǔshí plinth
仁|[rén] benevolence, humanity
損|[sǔn] decrease; damage; 损失 sǔnshī lose, loss
融|[róng] (融化) melt (ice or snow; cf 熔 róng)
輛|[liàng] 车辆 car; 两辆车 liǎng liàng chē two cars
凈|[jìng] clean, complete; only; 干净 gānjìng clean
敏|[mǐn] 敏捷 mǐnjié agile; 敏感 mǐngǎn sensitive; 敏锐 mǐnruì acute
伊|[yī] {family name}>, he or she; 伊斯兰 Yīsīlán Islam
仙|[xiān] fairy, saint, immortal celestial being; 仙女 fairy maiden
巧|[qiǎo] clever, coincidentally; 巧妙 qiǎomiào ingenious
零|[líng] zero; 零件 língjiàn spare part; 零钱 spare change<br /><br />[līng] 孤零零 gūlīnglīng solitary, all alone; 丁零零 dīnglīnglīng tinkle, jingle
累|[lèi] tired; work hard<br /><br />[lěi] 积累 accumulate<br /><br />[léi] (F纍)
享|[xiǎng] (=享受 xiǎngshòu) enjoy (compare with 亨 hēng)
伴|[bàn] accompany; 伙伴, 同伴 companion
蕩|[dàng] swing, sway; loaf about; 扫荡 wipe out; 震荡 shake
珍|[zhēn] (珍宝) treasure: 珍珠 pearl; 珍贵 precious
勇|[yǒng] 勇敢 yǒnggǎn brave; 勇气 courage; 勇士 brave warrior
末|[mò] end, minor details; 末儿 mòr powder; 周末 zhōumò weekend<br /><br />[me] (=么 me); 什末 shénme what?<br /><br />{Compare with 未 wèi haven't}
奮|[fèn] 奋斗 fèndòu struggle; 兴奋 xīngfèn excited
膽|[dǎn] gallbladder, guts, bravery, internal parts
棄|[qì] (放弃 fàngqì, 抛弃 pāoqì) abandon, give up
煩|[fán] be vexed; 麻烦 máfan trouble, bother; 不耐烦 bú nàifán impatient
糊|[hú] paste; 糊涂 hútu muddled<br /><br />[hū] plaster<br /><br />[hù] paste
猶|[yóu] still, yet; 犹豫 yóuyù hesitate; 犹如 yóurú as if
稅|[shuì] tax
培|[péi] 培养 foster, train, develop; 培育 cultivate, breed
抵|[dǐ] support; (抵抗 dǐkàng) resist
僧|[sēng] monk
鋒|[fēng] 锋利 sharp; 冲锋 charge, assault; 先锋 vanguard
乃|[nǎi] be, so, only then, you
遙|[yáo] distant, remote; long
摩|[mó] 按摩 ànmó massage; 摩擦 mócā rub; friction<br /><br />[mā] 摩挲 māsa gently stroke, smooth rub, massage
坦|[tǎn] 平坦 level; 坦然 calm; 坦克 tank
後|[hòu] after
眉|[méi] eyelash; 眉头 brows; 眉毛 eyebrow; 眉目 looks
餐|[cān] meal
慣|[guàn] be used to; 习惯 xíguàn be used to, habit, custom
憑|[píng] lean on, based on, (= 不论 búlùn) no matter
冠|[guān] hat, crown<br /><br />[guàn] first place; 冠军 guànjūn champion
抬|[tái] lift, raise, carry
碰|[pèng] bump into; 碰见 happen to meet
幣|[bì] money, currency; 硬币 coin; 人民币 rénmínbì RMB.
啟|[qǐ] open; start; enlighten; 启发 arouse, inspire
碼|[mǎ] {classifier for cloth, happenings, etc.}>; 两码事 liǎng mǎ shì two entirely differeint things/matters; 码头 mǎtou wharf, dock; 号码 hàomǎ (serial) number, code
冒|[mào] emit, risk, pretend to be, {family name}>; 感冒 catch a cold
汗|[hàn] (汗水 hànshuǐ) sweat, perspiration<br /><br />[hán] 可汗 kèhán
俗|[sú] common, rustic, vulgar, custom; 俗话 proverb, saying
灰|[huī] ash, dust, grey, disheartened
督|[dū] 监督 jiāndū supervise
窮|[qióng] poor; 无穷 wúqióng infinite
頗|[pō] quite, rather
傾|[qīng] lean; 倾向 tendency, prefer; 倾斜 slant
尖|[jiān] point, tip; 尖锐 jiānruì sharp
韓|[Hán] {family name}>; (old name for Korea)
貿|[mào] 贸易 màoyì trade
仿|[fǎng] resemble, be like, (=模仿 mófǎng) imitate, copy; 仿佛 seem; 仿造 copy
孤|[gū] alone; 孤儿 orphan; 孤立 isolated; 孤独 lonely
飄|[piāo] float in the air, flutter; 飘扬 flutter, wave
漫|[màn] overflow; 漫长 endless; 浪漫 làngmàn {loan}> romantic
予|[yǔ] (=予以 yǔyǐ, =给予 jǐyǔ) give, grant<br /><br />[yú] {archaic}> (=吾 wú) I, me
紫|[zǐ] purple, violet
側|[cè] side<br /><br />[zhāi] 侧歪 zhāiwai slant
沿|[yán] along; 沿海 yánhǎi coastal; 沿儿 yánr water's edge
拔|[bá] raise, pull; 提拔 promote; 海拔 elevation
袖|[xiù] (袖子) sleeve; 领袖 leader; 袖珍 pocket-sized; 短袖 duǎnxiù T-shirt
梁|[liáng] bridge, roof beam; 桥梁 bridge; 脊梁骨 backbone
賞|[shǎng] reward, admire; 欣赏 xīnshǎng enjoy, appreciate
幕|[mù] curtain; act (of play); 屏幕 píngmù screen
壁|[bì] wall, cliff; 墙壁 qiángbì wall (la pared)
旦|[dàn] {archaic}> dawn; 一旦 in one day; once; 元旦 New Year's Day
晨|[chén] (早晨 zǎochen) morning
純|[chún] (纯洁 chúnjié) pure; (单纯 dānchún) simple
閉|[bì] shut
涼|[liáng] cool, cold<br /><br />[liàng] make cool
掃|[sǎo] sweep; 打扫 dǎsǎo clean up<br /><br />[sào] 扫帚 sàozhou broom
尤|[yóu] fault; outstanding; 尤其 yóuqí especially
炮|[pào] cannon; 炮弹 shell<br /><br />[bāo] quick-fry<br /><br />[páo] 炮制 concoct
碗|[wǎn] bowl
貼|[tiē] stick, paste, glue, stay close to
插|[chā] insert, stick in; 插头 plug
滾|[gǔn] roll, boil
緣|[yuán] 缘故 cause, reason; 边缘 edge; 绝缘 insulate
寺|[sì] temple, Buddhist monastery
貝|[bèi] shellfish; cowrie; (money); 贝壳 bèiké shell<br /><br />{Compare with 见 jiàn see}
潤|[rùn] 湿润 shīrùn moist; 利润 lìrùn profit; 润滑 rùnhuá lubricate
氏|[shì] surname, family name, (=氏族 shìzú) clan<br /><br />[zhī] 月氏 Yuèzhī Indo-Scyths (nomadic people in Central Asia)
冬|[dōng] (=冬天 dōngtiān, =冬季 dōngjì) winter; 冬眠 dōngmián hibernation; 春夏秋冬 chūnxiàqiūdōng the four seasons
擴|[kuò] 扩大 kuòdà enlarge, expand
欄|[lán] fence, railing
荒|[huāng] desolate, wasteland, famine; 荒谬 huāngmiù absurd
哲|[zhé] 哲学 zhéxué philosophy
逼|[bī] force, compel; close in on
嚇|[xià] frighten, scare<br /><br />[hè] (=恐吓 kǒnghè) threaten, {interj.}>
堆|[duī] pile, heap<br /><br />[zuī] 归里包堆 guīlibāozuī altogether, all in all
撞|[zhuàng] collide, run into
郎|[láng] young man; 新郎 bridegroom. {family name}><br /><br />[làng] 屎壳郎
倆|[liǎ] two, both; 我们俩 wǒmen liǎ the two of us<br /><br />[liǎng] 伎俩 jìliǎng trick, intrigue, maneuver, skill, dexterity, craft
藍|[lán] (蓝色) blue
閑|[xián] idle, free time; 闲话 digression, complaint
辛|[xīn] suffering; 辛苦 xīnkǔ work hard
鏡|[jìng] (=镜子 jìngzi) mirror, lens; 眼镜 yǎnjìng glasses
陪|[péi] (=陪同 péitóng) accompany; 陪嫁 péijià dowry
騎|[qí] ride (horse/bike)<br /><br />[jì] 乘骑 chéngjì saddle horse; rider
蛋|[dàn] egg; 鸡蛋 chicken egg; 蛋白质 protein
促|[cù] urge; urgent; 促进 cùjìn promote; 促使 cùshǐ impel, urge
羊|[yáng] sheep; 山羊 shānyáng goat; 羊年 yángnián year of the Sheep = 8th year
宜|[yí] (=适宜 shìyí) suitable<br /><br />[yi] 便宜 piányi cheap
嘛|[ma] {particle for persuation}><br /><br />[má] {interrogative particle}> (=吗 ma)
顏|[yán] 颜色 yánsè colour; 颜面 yánmiàn face
貧|[pín] (=贫苦 pínkù, =贫穷 píngqióng) poor
幅|[fú] width of cloth, size, {classifier for cloth, paintings etc.}>; 一幅画 a picture
駐|[zhù] stay, halt, be stationed
萍|[píng] (=浮萍 fúpíng) duckweed
污|[wū] foul; 污染 wūrǎn pollution
傑|[jié] 杰出 outstanding; 杰作 masterpiece
撲|[pū] pounce on; flap wings; 扑灭 pūmiè extinguish; 扑克 pūkè {loan}> Poker
壯|[zhuàng] robust, magnificent; 壮丽 majestic; 壮族
薩|[sà] 菩萨 púsà bodhisattva, benevolent being, {family name}>
刑|[xíng] punishment
憂|[yōu] worry, grieve; 忧郁 yōuyù sad; 忧虑 worry about
貌|[mào] (面貌) appearance; 礼貌 polite
獄|[yù] lawsuit; (监狱 jiānyù) prison, jail
塞|[sāi] fill in, stuff, cork<br /><br />[sè] (=堵塞 dǔsè) block up, obstruct<br /><br />[sài] place of strategic importance, border pass
鳳|[fèng] male phoenix (fabulous bird of good omen)
孔|[kǒng] hole; 孔子 Kǒngzǐ Confucius; 面孔 miànkǒng face
觸|[chù] touch; 接触 jiēchù get in touch; 触角 antenna
戀|[liàn] 恋爱 love (as in love affair)
豈|[qǐ] (rhetorical adverb); 岂有此理 qǐyǒucǐlǐ What kind of reasoning is that?, Nonsence!
森|[sēn] (=森林 sēnlín) forest
繁|[fán] numerous; 繁殖 fánzhí breed; 繁荣 flourishing; 繁体字 fán tǐzì full forms of simplified characters
碎|[suì] smash to pieces
津|[jīn] ferry crossing, ford, saliva, sweat, moist, damp; 津津有味 jīnjīnyǒuwèi (to do someting) with pleasure, to be appetizing
俠|[xiá] 侠客 xiákè chivalrous warrior; 侠义 chivalrous
隆|[lóng] 隆重 lóngzhòng grand; 隆起 lóngqǐ swell<br /><br />[lōng] 轰隆隆 hōnglōnglōng tumble, roll
遲|[chí] tardy; 迟到 arrive late; 迟疑 hesitate; 推迟 put off<br /><br />[zhì] 迟旦 zhìdàn dawn, daybreak
輝|[huī] shine; 光辉 radiance, glory; 辉煌 huīhuáng brilliant
狠|[hěn] ruthless
析|[xī] 分析 fēnxī analyse
縮|[suō] shrink
穴|[xué] cave, hole, den, grave, acupuncture point
蕭|[xiāo] desolate
怨|[yuàn] resentment, complain
磨|[mó] rub, wear down<br /><br />[mò] mill, grind(stone)
伏|[fú] bend over, subside; 伏天 hot summer days; 起伏 rise and fall
辭|[cí] take leave; diction, poetry, language
泥|[ní] mud; 泥土 soil<br /><br />[nì] putty
齡|[líng] (年龄) age; duration
徑|[jìng] path, way; (直径 zhíjìng) diameter; 途径 tújìng channel, way, through
鼻|[bí] (=鼻子 bízi) nose; 鼻孔 bíkǒng nostril
賴|[lài] rely; hang around; blame falsely; deny error
仰|[yǎng] face upward; 信仰 xìnyǎng (religious) faith
憤|[fèn] (=气愤 qìfèn, =愤怒 fènnù) angry
慕|[mù] 羡慕 xiànmù envy; admire; 爱慕 àimù adore
俄|[é] very soon, suddenly; 俄国 ?guó Russia
映|[yìng] shine
詢|[xún] 询问 xúnwèn ask about, inquire
慘|[cǎn] tragic; savage
麥|[mài] wheat, etc; 麦片 màipiàn oatmeal; 麦克风 màikèfēng {loan}> microphone
宿|[sù] stay overnight, {family name}><br /><br />[xiǔ] {classifier for nights}>; 住一宿 zhù yì xiǔ stay one night<br /><br />[xiù] constellation in Chinese astronomy
倍|[bèi] times; 三倍 three times (as much)
粗|[cū] thick, rough, coarse
騰|[téng] jump, gallop, vacate; 沸腾 boiling<br /><br />[tēng] thump
稍|[shāo] (稍稍, 稍微) a little, a bit, slightly<br /><br />[shào] 稍息
截|[jié] cut, stop; section, length; 半截 half a section
染|[rǎn] to dye; catch (disease); 染料 dye; 污染 pollution
烏|[wū] (=乌鸦 wūyā) crow, (=乌黑 wūhēi) black; 乌龟 wūguī tortoise<br /><br />{Compare with 马 mǎ horse and 鸟 niǎo bird}
愈|[yù] heal, get better; 愈…愈… (like 越 yuè)
崗|[gǎng] mound, sentry<br /><br />[gāng] 花岗石 huāgāngshí granite<br /><br />[gàng] 岗口 gànkǒu delicious sweet
柳|[liǔ] willow
鋪|[pū] spread, unfold; pave<br /><br />[pù] shop, store; plank bed; 卧铺
涉|[shè] wade, ford, go through, involve; 干涉 gānshè interfere
疾|[jí] (=疾病 jíbìng) illness; 疾苦 jíkǔ hardship
擋|[dǎng] ward off, block, gear (of car)<br /><br />[dàng] 摒挡 bìngdàng arrange, get ready
奉|[fèng] accept, offer; 奉命 receive orders; 奉承 flatter
踏|[tà] step on; 糟蹋 (=糟蹋 zāota) zāota ruin, waste, insult, affront<br /><br />[tā] (=塌 tā) collapse, sink, calm down
忠|[zhōng] faithful
伍|[wǔ] (=五 wǔ) five, {family name}>; 队伍 duìwǔ troops
躲|[duǒ] hide (oneself), avoid, dodge
籍|[jí] book, registry, native place, membership; 国籍 guójí nationality
努|[nǔ] 努力 nǔlì try hard
朗|[lǎng] 爽朗 shuǎnglǎng, 明朗 bright and clear; 朗讼 recite
箱|[xiāng] box
裁|[cái] cut cloth or paper; reduce; decide; sanction
帳|[zhàng] curtain; 蚊帐 mosquito net; 帐篷 tent; account
兼|[jiān] double; simultaneously: 兼容 compatible
彼|[bǐ] 彼此 bǐcǐ each other
霞|[xiá] rosy clouds
豬|[zhū] pig; 猪年 zhūnián the year of the pig = the 12th year
悉|[xī] 熟悉 shúxī know well, be familiar with
扎|[zhā] prick<br /><br />[zhá] 挣扎 zhēngzhá struggle<br /><br />[zā] 包扎
勸|[quàn] advise
薄|[báo] thin<br /><br />[bó] slight; 薄弱 weak<br /><br />[bò] 薄荷 bòhe peppermint
築|[zhù] build, construct; 建筑学 architecture
俊|[jùn] handsome, pretty; 英俊 brilliant, talented
鞋|[xié] shoe
距|[jù] (距离 jùlí) distance
侵|[qīn] (=侵略 qīnlüè, =侵入 qīnrù) invade, intrude into
欣|[xīn] 欣赏 xīnshǎng enjoy
擠|[jǐ] squeeze; crowd; push, jostle; 拥挤 yōngjǐ crowded
媒|[méi] go-between, matchmaker; 媒介 medium, intermediary
吐|[tǔ] spit<br /><br />[tù] (呕吐 ǒutù) vomit
魂|[hún] (灵魂 línghún) soul, spirit, mood
潔|[jié] (=纯洁 chúnjié) pure, (=清洁 qīngjié) clean, sanitay; 洁白 jiébái pure white, spotless
枝|[zhī] branch<br /><br />[qí] (=歧 qí) fork, brach, divergent
盈|[yíng] full; 盈利 yínglì profit, have a surplus
阻|[zǔ] block; 阻止 zǔzhǐ prevent; 电阻 diànzǔ resistance
陷|[xiàn] pit, trap; cave in; 陷入 sink/fall into
甲|[jiǎ] helmet; 指甲 zhījia fingernail; 甲虫 beetle<br /><br />{Compare with 申 shēn explain and 由 yóu from}
鄭|[zhèng] {family name}>; 郑重 zhèngzhòng serious, solemn
鳴|[míng] cry of birds, animals, insects; ring, sound; express
倘|[tǎng] (=倘若 tǎngruò) if, supposing
剩|[shèng] be left over, remain, (=剩余 shèngyú) surplus, left over, remain
顆|[kē] grain, small round object, {classifier for small round things}>; 一颗珠子 yì kē zhūzi one pearl
拖|[tuō] pull, drag; procrastinate
舒|[shū] stretch; 舒服 shūfu comfortable; 舒畅 shūchàng carefree
惠|[huì] 恩惠 ēnhuì favor, kindness; 贤惠 xiánhuì virtuous (女)
昏|[hūn] dusk, dark, to faint
振|[zhèn] shake, stimulate; 振动 vibration; 振奋 inspire
戒|[jiè] forbid; 戒严 jièyán enforce martial law; 戒指 jièzhi ring
喪|[sàng] lose (by death), lose (sth. important); 丧失 sàngshī forfeit<br /><br />[sāng] mourning; 丧事 sāngshì funeral arrangements
焦|[jiāo] burnt; (焦炭) coke; 焦急 jiāojí anxious; 焦点 focus
爬|[pá] crawl, climb<br /><br />[pā] 矮爬爬 ǎipāpā squat, short
凌|[líng] insult; encroach; draw near; 凌晨 língchén before dawn
慧|[huì] 智慧 zhìhuì wisdom
偶|[ǒu] (偶然 ǒurán) by chance, even number<br /><br />{Compare with 奇 jī odd}
晃|[huàng] (摇晃 yáohuang) shake, sway<br /><br />[huǎng] dazzle<br /><br />[huāng]
桃|[táo] (桃子) peach; 桃花 peach blossom; 樱桃 yīngtáo cherry
赤|[chì] red, bare; 赤道 chìdào equator; 赤脚 chìjiǎo barefoot
爛|[làn] messy; 灿烂 cànlàn splendid<br /><br />[lān]
騙|[piàn] (欺骗) deceive; cheat, swindle; 骗局 hoax; 骗子 swindler
措|[cuò] arrange; 措施 cuòshī measure, step
頁|[yè] page
凶|[xiōng] terrible; 凶恶 xiōng'è fiendish; 凶猛 xiōngměng ferocious
泰|[tài] peace, quiet; 泰国 Thailand; 泰山 Tàishān Mount Tai, something of great importance
屍|[shī] corpse, 尸体 shītǐ dead body
坡|[pō] slope, hillside; 坡度 pōdù slope, gradient
勒|[lēi] tie or strap tightly<br /><br />[lè] 勒索 lèsuǒ
療|[liáo] treat, cure; 疗法 therapy
塔|[tǎ] pagoda, tower<br /><br />[da] 泥圪塔; 树圪塔
塵|[chén] (灰尘 huīchén) dust
躺|[tǎng] lie down
殊|[shū] 特殊 tèshū special, particular
慰|[wèi] 安慰 comfort, console; 慰问 express sympathy for
坛|[tán] (F壇) altar, raised plot of ground; (F罈) jar, jug
甘|[gān] sweet; 甘蔗 gānzhe sugarcane; 甘肃 Gānsù<br /><br />{Compare with 日 rì sun}
咬|[yǎo] bite; bark; pronounce
拒|[jù] resist; (拒绝 jùjué) refuse
彪|[biāo] young tiger
炸|[zhà] (爆炸 bàozhà) explode, blow up<br /><br />[zhá] deep fry
井|[jǐng] (water) well, {family name}>
崇|[chóng] worship, high, sublime
飲|[yǐn] drink<br /><br />[yìn] give animals water to drink
祝|[zhù] express good wishes; 庆祝 qìngzhù celebrate; 祝贺 zhùhè congratulate; 祝福 zhùfú invoke/give blessing
汪|[wāng] 汪汪 wāngwāng tearful, bow-wow; 汪洋 boundless (ocean)
牢|[láo] firm, durable; (牢房 láofáng) prison; 牢固 láogù sturdy
桂|[guì] laurel (bay) tree; 桂林 Guìlín
尾|[wěi] (=尾巴 wěiba) tail<br /><br />[yǐ] 后尾 hòuyǐ {colloquial}> end, behind
漂|[piāo] float<br /><br />[piào] 漂亮 paiòliang beautiful<br /><br />[piǎo] 漂白 piǎobái bleach
聊|[liáo] just, slightly; 无聊 wúliáo bored, silly; 聊天儿 liáotiānr chat, gossip
撒|[sā] cast, let go<br /><br />[sǎ] scatter, sprinkle
恰|[qià] (恰当 qiàdàng) appropriate, suitable; 恰好 qiàhǎo just right
凝|[níng] 混凝土 hùnníngtǔ concrete; 凝视 níngshì stare; 凝固 nínggù solidify
矛|[máo] spear; 矛盾 máodùn "spear-shield" = contradiction
於|[Yū] {family name}><br /><br />[wū] {archaic}> sigh and exclaim<br /><br />[yú] (S于) in, at, to, from, by, than
賓|[bīn] guest; 宾馆 bīnguǎn hotel<br /><br />{Compare with 兵 bīng soldier}
緒|[xù] 情绪 qíngxù mood, depression; 头绪 tóuxù lead, clue
彭|[Péng] {family name}>
肚|[dù] (肚子 dùzi) stomach<br /><br />[dǔ] tripe
匆|[cōng] urgent, rushed; 匆匆 cōngcōng hurriedly, obviously, apparently; 匆忙 cōngmáng in a hurry
描|[miáo] trace, touch up; 描写 miáoxiě describe
粉|[fěn] powder; 洗衣粉 xǐyīfěn laundry detergent; 粉红色 fěnhóngsè pink
賊|[zéi] thief
乏|[fá] (=缺乏quēfá) lack; 疲乏 pífá tired; 贫乏 pínfá poor
盾|[dùn] shield; 矛盾 máodùn "spear-shield" = contradiction
愁|[chóu] worry
斜|[xié] slanting; 斜边 xiébiān hypoteneuse; 斜率 xiélǜ slope
裂|[liè] split, crack: 分裂 fēnliè split, divide, break up, fission<br /><br />[liě] crack open
滑|[huá] slip, slide, smooth, slippery; 滑冰 huábīng ice-skate
斐|[fěi] to possess literary talent; 斐然 fěirán brilliant (of literature); 斐济 Fěijì Fiji
廢|[fèi] waste
寂|[jì] 寂寞 jìmò lonely; 寂静 jìjìng quiet (place); 沉寂 chénjì quiet
涌|[yǒng] gush, pour, rise, surge; 汹涌 xiōngyǒng turbulent
詳|[xiáng] 详细 xiángxì detailed; 端详 duānxiáng details; 安详 ānxiáng serene
湯|[tāng] hot water, soup<br /><br />[shāng] 汤汤 shāngshāng to flow turbulently
徹|[chè] 彻底 chèdǐ thorough; 贯彻 guànchè carry out, implement
玄|[xuán] black, dark, profound, abstruse; 玄学 xuánxué metaphysics
斤|[jīn] half a kilogram; 公斤 gōngjīn kilogram
轟|[hōng] bang, boom, rumble, bomb, attack, drive out; 轰轰烈烈 hōnghōnglièliè grand, spectacular
奸|[jiān] treacherous, traitor; (F姦) adultery; 强奸 qiángjiān rape
憐|[lián] 可怜 kělián poor, pitiful
朵|[duǒ] (=朵儿 duǒr) flower, {classifier for flowers, clouds etc.}>; 一朵花 yì duǒ huā; 一朵云<br /><br />[duo] 耳朵 ěrduo ear
佳|[jiā] good, beautiful
皆|[jiē] {slightly archaic}> all, everyone
鳥|[niǎo] bird<br /><br />[diǎo] (=屌)<br /><br />{Compare with 乌 wu crow}
邦|[bāng] nation, state, country; 城邦 chéngbāng city-state; 乌托邦 wūtuōbāng utopia
扶|[fú] support with the hand, help
毀|[huǐ] destroy; 毁灭 huǐmiè exterminate
聰|[cōng] 聪明 cōngming clever, intelligent, bright
辯|[biàn] (辩论 biànlùn) debate, argue; 辩证 diagnosis
瓶|[píng] (=瓶子 píngzi) bottle
餓|[è] hungry
蛇|[shé] snake<br /><br />[yí] 虚与委蛇 xūyǔwēiyí pretended interest and sympathy
捕|[bǔ] catch; 逮捕 dàibǔ arrest
搬|[bān] move; 搬家 move house
沈|[Shěn] {family name}>, liquid essence; (F瀋) 沈阳 Shěnyáng; 墨沈未干 mòshěnwèigān "before the ink is dry"<br /><br />[chén] (=沉) to sink
楓|[fēng] Chinese sweet gum (tree); maple
舅|[jiù] 舅舅 jiùjiu uncle, mother's brother
幽|[yōu] 幽静 secluded; 幽默 humor; 幽暗 gloomy; 幽灵 ghost
魔|[mó] evil spirit, (=恶魔 èmó, =魔鬼 móguǐ) demon; 魔术 móshù magic
琴|[qín] zither-like instrument; 钢琴 piano; 小提琴 violin
掙|[zhèng] struggle; earn<br /><br />[zhēng] 挣扎 zhēngzhá struggle
聘|[pìn] engage; 聘请 pìnqǐng engage, invite
彎|[wān] curve, bend
墓|[mù] (=坟墓 fénmù) grave, tomb
欺|[qī] (=欺骗 qīpiàn) cheat, deceive, (=欺负 qīfu) bully
悟|[wù] realize; 觉悟 consciousness; 孙悟空
蔣|[Jiǎng] {family name}>
臣|[chén] high official, overseer, (=大臣 dàchén) minister
返|[fǎn] (=返回 fǎnhuí) return, go back
違|[wéi] disobey, (=违反 wéifǎn, =违背 wéibèi) violate; 违法 wéifǎ break the law
虧|[kuī] lose (money); 吃亏 chīkuī suffer a loss, come to grief, treat unfairly; 幸亏 xìngkuī fortunately, luckily
丟|[diū] lose, misplace
援|[yuán] hold, help; 支援 zhīyuán support; 援助 yuánzhù help
赫|[Hè] {family name}>, hertz
魏|[Wèi] one of the Three Kingdoms, name of several dynasties, {family name}>
耐|[nài] be able to endure; 有耐心 yǒubàixīn patient; 不耐烦 bú nàifán impatient
佩|[pèi] wear (at the waist), admire, pendant waist ornament; 佩服 pèifu admire; 敬佩 jìngpèi esteem
酸|[suān] sour, acid
盟|[méng] (联盟 liánméng) alliance, pact<br /><br />[míng] 盟誓 míngshì oath of alliance
胖|[pàng] fat, plump<br /><br />[pán] {archaic}> easy and comfortable
傻|[shǎ] stupid, idiotic; 傻子 shǎzi, 傻瓜 shǎguā idiot
繞|[rào] wind, coil, move around; 围绕 wéirào surround
哼|[hēng] groan, snort, hum<br /><br />[hng] humph
秦|[Qín] the Qin Dynasty 221-207 B.C., {family name}>
屈|[qū] bend, submit, injustice; 屈服 qūfú surrender, yield; 委屈 wěiqu feel wronged, srong somebody
辱|[rǔ] 侮辱 wǔrǔ insult, humiliate; 耻辱 chǐrǔ shame
昨|[zuó] (=昨天 zuótiān) yesterday; 昨晚 zuówǎn yesterday evening<br /><br />{Compare with 咋 zǎ how}
瘦|[shòu] thin, lean, frail, skinny
暫|[zàn] (=暂时 zànshí) temporary
箭|[jiàn] arrow; 火箭 huǒjiàn rocket; 箭头 jiàntóu arrowhead
署|[shǔ] (=署名 shǔmíng, =签署 qiānshǔ) sign one's name; 部署 bùshǔ deploy
赴|[fù] go to, attend
遞|[dì] hand over, pass, give; 递交 dìjiāo deliver, hand on, present, submit
猜|[cāi] guess; 猜想 cāixiǎng suppose
潛|[qián] 潜水艇 qiánshuǐtǐng submarine; 潜力 qiánlì latent ability
鴻|[hóng] (鸿雁 hóngyàn) swan, wild goose, vast
績|[jì] 成绩 grade, achievement; 功绩 merits and achievements
耀|[yào] shine, dazzle
塗|[tú] spread on; 涂料 túliào coating<br /><br />[tu] 糊涂 hútu muddled<br /><br />[tū] 糊里八涂 húlibātū confused, muddle-headed
割|[gē] cut; 收割 shōugē to harvest
豆|[dòu] bean; 豆腐 dòufu tofu; 大豆 dàdòu soybean; 豌豆 wāndòu pea
悶|[mēn] muffled (of sound), stuffy, cut off from air circulation<br /><br />[mèn] bored, depressed
亭|[tíng] (=亭子 tíngzi) pavilion, kiosk
祥|[xiáng] (=吉祥 jíxiáng) auspicious; 慈祥 cíxiáng kindly, mercy
勵|[lì] 鼓励 gǔlì, 激励 jīlì encourage; 奖励 jiǎnglì reward
宇|[yǔ] eaves, universe; 宇宙 yǔzhòu cosmos; 庙宇 miàoyǔ temple
泛|[fàn] flood; 广泛 guǎngfàn wide, extensive; 泛滥 fànlàn overflow
狼|[láng] wolf, greedy and cruel person; 狼狈 lángbèi in a difficult position
悔|[huǐ] (=后悔 hòuhuǐ) regret, repent
搭|[dā] put up, hang over, lift together<br /><br />[dá] 搭茬儿 dáchár pursue another's utterance; 哪搭 nǎdá where, wherever
艦|[jiàn] (=军舰 jūnjiàn) warship; 航空母舰 hángkōngmǔjiàn aircraft carrier
浮|[fú] float
牽|[qiān] lead along (by hand, halter, etc.); 牵牛下地 qiānniú xià dì
符|[fú] 符合 fúhé conform to; 符号 fúhào mark, symbol
肅|[sù] 严肃 yánsù serious, solemn; 肃清 sùqīng eliminate
奴|[nú] (=奴隶 núlì) slave
爆|[bào] (=爆炸 bàozhà) explode, (=爆发 bàofā) erupt, burst; 爆竹 bàozhú firecracker
姊|[zǐ] elder sister; 姊妹 zǐmèi sisters
幼|[yòu] young, children; 幼稚 yòuzhì childish; 幼儿 child
夾|[jiā] press, squeeze, clip<br /><br />[jiá] lined (clothing)<br /><br />[gā] 夹肢窝 gāzhiwō armpit
邀|[yāo] (邀请 yāoqǐng) invite
瘋|[fēng] crazy
允|[yǔn] 允许 yǔnxǔ permit, allow
惱|[nǎo] 恼火 nǎohuǒ angry, annoyed
租|[zū] rent; 出租汽车 chūzūqìchē taxi
椅|[yǐ] (椅子 yǐzi) chair
尺|[chǐ] ruler, one-third of a meter; 英尺 yīngchǐ (English) foot<br /><br />[chě] 工尺 gōngchě traditional Chinese musical notation
侍|[shì] 侍候 shìhòu wait upon, look after
腐|[fǔ] rotten; 豆腐 tofu; 腐蚀 corrode; 腐败 corrupt
顫|[chàn] quiver; 颤抖 chàndǒu tremble; 颤动 chàndòng vibrate<br /><br />[zhàn] tremble, shudder
扭|[niǔ] twist, turn around, seize; 别扭 bièniu awkward<br /><br />[niū] 吱扭 zīniū squeak
菲|[fěi] 菲薄 fēibó humble<br /><br />[fēi] luxuriant; 菲律宾 Fěilǜbīn Philippines
瓦|[wǎ] tile; (瓦特 wǎtè) Watt<br /><br />[wà] to tile a roof<br /><br />[wā] 蓝瓦瓦 lánwāwā dazzling blue
擦|[cā] rub, wipe, scrape
辣|[là] spicy; 辣椒 làjiāo hot pepper; 毒辣 dúlà sinister<br /><br />[lā] 热辣辣 rèlālā burning hot, impassioned, passionate
奏|[zòu] play music; 演奏 yǎnzòu perform music; 节奏 jiézòu rhythm
殷|[yīn] rich, {family name}><br /><br />[yān] (=殷红 yānhóng) blackish red, dark red
埋|[mái] bury, cover up<br /><br />[mán] 埋怨 mányuàn blame, complain
摔|[shuāi] fall down; 摔交 shuāijiāo wrestling
盼|[pàn] look, (=盼望 pànwàng) hope for, look forward to
吟|[yín] chant, recite<br /><br />[yīn] 笑吟吟 xiàoyīnyīn smilingly
渡|[dù] cross a river/sea/etc., tide over, ferry across; 渡船 dùchuán ferry
衫|[shān] (=衬衫 chènshān) shirt
跨|[kuà] step, stride, straddle, go beyond
醉|[zuì] drunk
艱|[jiān] (=艰难 jiānnán) difficult, (=艰苦 jiānkǔ) arduous
掩|[yǎn] hide, sneak attack; 掩护 yǎnhù to shield; 掩盖 yǎngài conceal
荷|[hé] lotus; 荷花 héhuā lotus flower<br /><br />[hè] carry, load
蒼|[cāng] dark green or blue; 苍天 blue sky; 苍松 green pine; 苍蝇 cāngying fly, mosquito; 苍白 cāngbái pale, lifeless, grayish
旋|[xuán] spin; 旋转 xuánzhuǎn rotate<br /><br />[xuàn] whirl, lathe
揭|[jiē] uncover
桑|[sāng] mulberry tree; 桑蚕 sāngcán silkworm; 桑叶 sāngyè mulberry leaves
仗|[zhàng] battle, war; 打仗 dǎzhàng wage a war, fight a battle
蓮|[lián] lotus, water lilly
鑽|[zuān] drill, get into, study<br /><br />[zuàn] drill, auger, diamond, watch jewel
宏|[hóng] 宏伟 hóngwěi magnificient; 宏大 hóngdà great; 宏观 hóngguān macroscopic
幻|[huàn] unreal, imaginary, magical; 科幻小说 kēhuàn xiàoshuō science fiction novel
刃|[rèn] (=刀刃 dāorèn) sharp edge of knife or sword, kill with knife or sword
峽|[xiá] (=峡谷 xiágǔ) gorge, canyon; 海峡 hǎixiá strait, channel; 三峡 Sān Xiá the Three Gorges of the Yangtze river
遼|[liáo] 辽阔 liáokuò vast, extensive; 辽宁 Liáoníng (a province)
娃|[wá] (娃娃 wáwa) baby
凱|[kǎi] 凯歌 kǎigē song of triumph
患|[huàn] worry, anxiety, disaster; 患病 huànbìng fall ill
障|[zhàng] barrier, obstacle, (=障碍 zhàng'ài) obstruct; 保障 bǎozhàng ensure
丐|[gài] (=乞丐 qǐgài) beggar
衡|[héng] weighing equipment, (=衡量 héngliang) weigh, measure, judge
貓|[māo] cat; 熊猫 xióngmāo panda; 猫头鹰 māotóuyīng owl<br /><br />[máo] 猫腰 máoyāo stoop, crouch
丑|[chǒu] second Earthly Branch, a clown in an opera, {faily name}>; (F醜) 丑陋 chǒulòu ugly, disgraceful, scandalous
濤|[tāo] great waves
暖|[nuǎn] warm up, (=温暖 wēnnuǎn) warm; 暖和 nuǎnhuo nice and warm
溜|[liū] slide, sneak away<br /><br />[liù] swift current of water
鍋|[guō] pot, wok, frying pan; 锅贴 guōtiē pot sticker
奈|[nài] what?, how?; 无可奈何 wúkěnàihé have no alternative
罰|[fá] (=惩罚 chéngfá) punish, (=罚款 fákuǎn) penalty
拾|[shí] pick up from the ground, ten (=十 shí); 收拾 shōushi put in order<br /><br />[shè] 拾级 shèjí climb stairs
濃|[nóng] dense, thick, concentrated; 浓度 nóngdù consistency
鍵|[jiàn] key; 键盘 jiànpán keyboard (piano or typewriter)
脈|[mài] vein, pulse; 山脉 shānmài mountain range<br /><br />[mò] 脉脉 mòmò lovingly
鎖|[suǒ] lock
鄰|[lín] (=邻居 línjū) neighbor
臭|[chòu] stinking<br /><br />[xiù] sniff, smell
芳|[fāng] perfume, (=芳香 fāngxiāng) fragrant; 芳龄 fānglíng age (when speaking of a young woman)
垂|[chuí] hang down, droop; 垂直 chúizhí vertical, perpendicular
捉|[zhuō] clutch, grasp, catch; 捉迷藏 zhuō mícáng to play "hide-and-seek"
恢|[huī] 恢复 huīfù recover, restore
姆|[mǔ] nurse
砍|[kǎn] cut, chop, hack; 砍柴 kǎnchái cut firewood
駕|[jià] (驾驶 jiàshǐ) drive, fly, sail; 劳驾 láojià excuse me...
恭|[gōng] respect; 恭贺新禧 gōnghèxīnxǐ Happy New Year
挨|[āi] get close to, be next to, in sequence<br /><br />[ái] suffer
禍|[huò] misfortune
曹|[Cáo] {family name}>
慈|[cí] 慈祥 cíxiáng kindly; 慈爱 cí'ài love, kindness; 慈悲 cíbēi mercy
抖|[dǒu] (=发抖 fādǒu, =颤抖 chàndǒu) shiver, tremble
泉|[quán] spring, (=喷泉 pēnquán) fountain; 源泉 yuánquán source
覽|[lǎn] 展览 zhǎnlǎn exhibition; 游览 yóulǎn go sightseeing
澳|[ào] bay, inlet (used in place names); 澳门 Aomen; 澳大利亚
脏|[zāng] (F髒) dirty<br /><br />[zàng] (F臟) 心脏 xīnzàng heart
疼|[téng] sore, painful
銅|[tóng] copper (Cu); 青铜 qīngtóng bronze
羞|[xiū] (=羞耻 xiūchǐ) shame, shy; 羞愧 xiūkuì feel ashamed
檔|[dàng] shelves; 档案 dàng'àn files, archives<br /><br />[dǎng] 骂档子 mà dǎngzi target of scolding; 逻辑档 luójidǎng logical data files
拋|[pāo] throw; 抛弃 pāoqì abandon; 抛锚 pāomáo drop anchor
苗|[miáo] seedling, young plant, vaccination; 火苗 huǒmiáo flame
惑|[huò] 疑惑 yíhuò uncertain<br /><br />[huo] 迷惑 míhuo perplex
肥|[féi] (=肥胖) fat, fertile, (=肥料) fertilizer; 肥皂 féizào soap
驅|[qū] 驱逐 qūzhú drive out, expel
窩|[wō] nest; 窝棚 wōpeng shack
褲|[kù] (=裤子) pants
估|[gū] 估计 gūjì estimate, guess<br /><br />[gù] 估衣 gùyi secondhand clothes
胞|[bāo] womb, placenta; 细胞 xìbāo cell
柄|[bǐng] handle
闊|[kuò] wide; 广阔 guǎngkuò vast; 宽阔 kuānkuò broad; 辽阔 liáokuò extensive
杜|[dù] {family name}>; 杜鹃 dùjuān cuckoo, azalea; 杜绝 dùjué stop, cut off
勤|[qín] (勤劳 qínláo) diligent, hardworking
舟|[zhōu] boat, ship
帽|[mào] (=帽子 màozi) hat, headgear, cap
瑪|[mǎ] 玛瑙 mǎnǎo agate; 玛雅 Mǎyǎ Maya
撤|[chè] remove, take away, withdraw, evacuate
頻|[pín] frequently; 频率 pínlǜ frequency
禪|[chán] meditation, Zen, Dhyana<br /><br />[shàn] 禅让 shànràng abdicate
柯|[kē] {archaic}> stalk, branch, {family name}>
萊|[lái] 莱菔 láifú radish; 文莱 Wénlái Brunei
堪|[kān] may, endure; 不堪 bùkān can't stand; 难堪 nánkān intolerable
寸|[cùn] inch
哀|[āi] grief; 悲哀 sorrowful; 哀求 āiqiú entreat, implore
熊|[xióng] bear, {family name}>; 熊猫 xióngmāo panda
腹|[fù] belly, stomach, abdomen; 腹地 hinterland
嘗|[cháng] taste
敲|[qiāo] knock, strike; 敲门 qiāo mén knock on a door; 敲锣 qiāo luó beat a gong
勃|[bó] suddenly; 勃勃 bóbó vigorous
巡|[xún] patrol; 巡视 xúnshì make a tour of inspection
盜|[dào] (=盗窃 dàoqiè) steal; 强盗 qiángdào robber
籌|[chóu] chip, counter, prepare, plan
扣|[kòu] button up; 纽扣儿 niǔkòur button; 扣子 kòuzi knot, button
池|[chí] pond, {family name}>, (=池塘 chítáng) pool; 游泳池 yóuyǒngchí swimming pool; 电池 diànchí battery
淺|[qiǎn] shallow, light
柴|[chái] firewood; 火柴 huǒchái match; 柴油 cháiyóu diesel oil
埃|[āi] dust, angstrom; 埃及 Aījí Egypt
嫁|[jià] marry (referring to a woman)
枚|[méi] {classifier for small objects, coins, etc.}>
稀|[xī] scarce, watery; 稀饭 xīfàn rice porridge, rice soup
雕|[diāo] vulture, (=雕刻 diāokè) carve, engrave; 浮雕 fúdiāo relief sculpture
厭|[yàn] (=讨厌 tǎoyàn, =厌恶 yànwù) detest; 厌烦 yànfán boring<br /><br />[yān] (=恹 yān) 恹恹 yānyān weak and weary thrugh illness
瓜|[guā] melon, gourd; 西瓜 xīguā watermelon; 傻瓜 shǎguā idiot; 黄瓜 huánggua cucumber
壽|[shòu] longevity; 寿命 shòumìng life-span
跌|[diē] fall, tumble
扯|[chě] pull, tear, chat
董|[dǒng] director; 古董 gǔdǒng antique
錦|[jǐn] brocade; 什锦 shíjǐn fancy; 素什锦 sùshíjǐn assorted vegetables
鑒|[jiàn] reflect, mirror, inspect, examine, take as a lesson, ancient bronze mirror, warning, object lesson; 鉴定 jiàndìng appraise; 借鉴 jièjiàn draw lessons from
刷|[shuā] brush, to brush, to paint, swish<br /><br />[shuà] 刷选 shuàxuǎn choose, pick, select; 刷白 shuàbái white, pale, brush over
趨|[qū] walk fast, hurry, (=趋向 qūxiàng) tend, incline to; 趋势 qūshì tendency
捐|[juān] contribute, relinquish, tax
傲|[ào] (骄傲 jiāo'ào) proud, arrogant
貫|[guàn] 贯彻 guànchè carry out; 一贯 yíguàn consistent
殿|[diàn] hall, palace
撥|[bō] poke, turn, stir; 拨钟 bōzhōng set a clock; 拨电话 bō diànhuà dial a phone
遜|[xùn] 谦逊 qiānxùn modest
踢|[tī] kick; 踢足球 tī zúqiú play football
賠|[péi] compensate, pay for, lose money; 赔不是 péi bùshi apologize
姿|[zī] appearance, gesture, (=姿势 zīshì, =姿态 zītài) posture
遷|[qiān] move, change; 变迁 biànqiān changes; 迁就 qiānjiù yield to
黎|[lí] mulititude, {family name}>; 黎明 límíng daybreak
祭|[jì] sacrifice; 祭器 jìqì sacrificial utensil
滴|[dī] drip, drop
襲|[xí] make a surprise attack, carry on as before
慌|[huāng] flustered, confused; 慌忙 huāngmáng in a flurry
鞭|[biān] whip
茫|[máng] 茫茫 mángmáng vast, boundless and indistinct
逢|[féng] meet
屠|[tú] butcher, kill
昆|[kūn] 昆虫 kūnchóng insect; 昆明 Kūnmíng
柏|[bǎi] (=柏树 bǎishù) cypress<br /><br />[Bó] 柏林 Bólín Berlin<br /><br />[bò] (=檗) 黄柏 huángbò the bark of a cork tree, golden cypress
駛|[shǐ] sail, move along quickly (speaking fo vehicles), (=驾驶 jiàshǐ) drive
咐|[fù] 吩咐 fēnfù tell, instruct; 嘱咐 zhǔfu enjoin, tell
植|[zhí] to plant; 植物 zhíwù plant
懼|[jù] fear, dread
紐|[niǔ] 纽扣儿 niǔkòur button, knob, handle, tie
捷|[jié] 敏捷 mǐnjié quick, agile; 轻捷 qīngjié nimble, spry
圳|[zhèn] irrigation ditch; 深圳 Shēnzhèn (place name)
牲|[shēng] 牺牲 xīshēng sacrifice; 牲口 shēngkou beasts of burden
蹤|[zōng] 跟踪 gēnzōng follow closely; 失踪 shīzōng be missing; 踪迹 zōngjì trace
叢|[cóng] crowd; 丛书 cóngshū series of books; 丛林 cónglín jungle
漠|[mò] 沙漠 shāmò desert; 漠然 mòrán apathetically
銳|[ruì] 尖锐 jiānruì sharp pointed, acute; 锐利 ruìlì sharp, keen
喇|[lǎ] 喇叭 lǎba musical wind instrument; 喇嘛 lǎma lama<br /><br />[lā] 喇喇 lāla drip (water/etc.); 哗啦 huālā sound of rustling/crashing/etc.<br /><br />[lá] 哈喇子 hālázi saliva; 咋喇 zhālá harangue, shoot off the mouth
乾|[qián] heaven; 乾道 qiándào ways of heaven, natural law; 乾坤 qiánkūn heaven and earth, the universe<br /><br />[gān] (S干) dry, hollow
霍|[huò] suddenly
濕|[shī] moist
睜|[zhēng] open the eyes
仔|[zǐ] 仔细 zǐxì careful<br /><br />[zǎi] young animal<br /><br />[zī] 仔肩 zījiān burdens, responsibility
吵|[chǎo] make noise<br /><br />[chāo] 吵吵 chāochao make noise
悠|[yōu] long, drawn-out, leisurely; 悠久 yōujiǔ age-old
溝|[gōu] gulley, trench
墨|[mò] ink stick, (=墨水 mòshuǐ) ink; 墨子 Mòzǐ (a philosopher)
串|[chuàn] string together, bunch, cluster; 羊肉串 yángròuchuàn sheep meat kebab
俱|[jù] all; 俱乐部 jùlèbù club<br /><br />[jū] together
陶|[táo] pottery; 陶瓷 táocí ceramics
貢|[gòng] 贡献 gòngxiàn contribute
渾|[hún] 浑身 húnshēn from head to foot, all over
贏|[yíng] win
屁|[pì] flatulence, fart, nonsence, rubbish, (=屁股 pìgu) buttocks
馳|[chí] gallop, speed, spread; 驰名 chímíng well-known
棒|[bàng] stick, bat, excellent; 棒球 bàngqiú baseball
匹|[pǐ] {classifier for horses, mules, bolts of cloth, etc.}>; 三匹马 sān pǐ mǎ three horses
拼|[pīn] (拼凑 pīncòu) piece together; 拼音 pīnyīn; 拼写 pǐnxiě spell, transliterate
恆|[héng] permanent
邪|[xié] evil, {interrogative sentence final particle}><br /><br />[yé] (=耶 yé) {interrogative particle}>
脆|[cuì] brittle, crisp; 干脆 gāncuì simply; 清脆 qīngcuì clear; 脆弱 cuìruò fragile
糟|[zāo] rotten; 糟糕 zāogāo bad luck! 糟踏 zāota waste, spoil
扮|[bàn] dress up as, disguise as; put on an expression
賢|[xián] 贤惠 xiánhuì virtuous and dutiful (woman); 贤人 xiánrén virtuous person
飾|[shì] decoration, dress up, impersonate
償|[cháng] repay, (=赔偿 péicháng) compensate, pay for
拆|[chāi] take apart, dismantle<br /><br />[cā] 〈collquial〉 excrete
纏|[chán] to wind, tie up, tangle, bother
攝|[shè] absorb, photograph; 拍摄 pāishè take a picture
擬|[nǐ] (=拟定 nǐdìng) draft; 比拟 bǐnǐ comparison; 模拟 mónǐ imitate
滋|[zī] 滋味 zīwèi flavor; 滋长 zīzhǎng grow
嘿|[hēi] hey
旨|[zhǐ] 意旨 yìzhǐ intention
闖|[chuǎng] rush, charge
賀|[hè] 祝贺 zhùhè congratulate; 庆贺 qìnghè celebrate
翠|[cuì] emerald green; 翠鸟 cuìniǎo kingfisher
縫|[féng] sew<br /><br />[fèng] seam, crack
飽|[bǎo] full (after meal)
劫|[jié] rob, disaster
撫|[fǔ] pat, soothe, foster; 抚摸 fǔmō stroke
挖|[wā] dig, excavate
冊|[cè] book; 手册 shǒucè handbook; 地图册 dìtúcè atlas<br /><br />{Compare with 丽 lì beautiful and 朋 péng friend}
叛|[pàn] 叛徒 pàntú traitor
肖|[xiào] 肖像 xiàoxiàng portrait<br /><br />[Xiāo] {family name}>
熙|[xī] splendid, (=缉熙 jīxī) bright, brilliand; 康熙字典 Kāngxī Zìdiǎn Kangxi dictionary (1716 A.D.)
煉|[liàn] smelt, refine, temper metal; 锻炼 duànliàn exercise
憲|[xiàn] 宪法 xiànfǎ constitution; 宪兵 xiànbīng military police
廟|[miào] temple
碧|[bì] green jade, bluish green; 碧绿 dark green; 碧蓝 dark blue; 雪碧 Xuěbì "7up", "Sprite"
盒|[hé] (=盒子 hézi) box
誼|[yì] 友谊 yǒuyì friendship
儲|[chǔ] 储量 chǔliàng reserves; 存储 cúnchǔ memory
馮|[píng] swift-running horse<br /><br />[Féng] {family name}>
喚|[huàn] (=叫唤 jiàohuan) call out
貪|[tān] corrupt; 贪心 tānxīn greedy
臥|[wò] lie down; 卧室 wòshì bedroom
翼|[yì] wing
擾|[rǎo] harass, bother, trouble; 扰乱 rǎoluàn disturb
脅|[xié] upper part of side of person's body, coerce
跪|[guì] kneel
碑|[bēi] upright stone tablet (monument, etc); 墓碑 mùbēi tombstone
呵|[hē] breathe out (mouth open), scold; 呵欠 hēqiàn yawn
甜|[tián] sweet; 甜菜 tiáncài beet
洒|[sǎ] (F灑) sprinkle<br /><br />[xiǎn] 洒如 xiǎnrú respectful, deferential; (F灑) 洒然 xiǎnrán alarmed, surprised, shocked, frightened, cold
譜|[pǔ] table, chart, manual, music score, (=谱写 pǔxiě) compose (music etc.)
莎|[shā] (used in names)<br /><br />[suō] 摩莎 mósuō stroke, caress
娜|[nuó] 婀娜 ēnuó graceful (woman)
閣|[gé] pavilion, cabinet
庸|[yōng] usual, ordinary; 中庸 Zhōngōng Doctrine of the Golden Mean
鵬|[péng] roc (a giant mythical bird)
覆|[fù] (=覆盖 fùgài) cover; 顛覆 diānfù subvert; (S复) 反覆 fǎnfù repeatedly, again and again
玲|[líng] 玲珑 línglóng clever and nimble
侯|[hóu] marquis, {family name}>
抹|[mā] slip something off, 〈colloquial〉 wipe<br /><br />[mǒ] apply, smear, brush/wipe off, exclude, play (cards/etc.); 抹布 mǒbù cloth, rag; 抹杀 mǒshā obliterate<br /><br />[mò] daub, plaster, skirt, bypass
盧|[Lú] {family name}>; 觚卢 gūlú calabash
礙|[ài] 障碍 zhàng'ài get in the way; 妨碍 fáng'ài hinder
綜|[zōng] 综合 zōnghé synthesize<br /><br />[zèng] heddle
丘|[qiū] mound, grave; 丘陵 qiūlíng hills; 沙丘 shāqiū dune
暈|[yūn] faint, swoon; 头晕 tóuyūn dizzy<br /><br />[yùn] dizzy, faint, halo; 红晕 hóngyùn blush
攔|[lán] block the way
燃|[rán] (燃烧 ránshāo) burn; 燃料 ránliào fuel
昌|[chāng] prosperous
吞|[tūn] swallow, gulp down, annex; 吞没 tūnmò embezzle
嫌|[xián] suspicion, dislike
狄|[Dí] {family name}>
押|[yā] pawn, detain; 押送 yāsòng send under escort; 押韵 yāyùn rhyme
舌|[shé] (=舌头 shétou) tongue<br /><br />{Compare with 古 gǔ ancient}
琳|[lín] {archaic}> beautiful jade
霧|[wù] fog; 烟雾 yānwù smoke, mist
曼|[màn] prolonged, graceful
恥|[chǐ] (=耻辱 chǐrǔ) shame, humiliation; 可耻 kěchǐ shameful; 无耻 wǔchǐ shameless
柜|[guì] (F櫃) (=柜子 guìzi) cabinet; 柜台 guìtái counter; 掌柜 zhǎngguì shopkeeper<br /><br />[jǔ] 柜柳 jǔliǔ tree of the willow family,large tree good for making furniture/etc.
攤|[tān] spread out, unfold, take a share in, vendor's stall
削|[xuē] 剥削 bōxuē to exploit<br /><br />[xiāo] 切削 qiēxiāo cut
戚|[qī] 亲戚 qīnqī relative; 休戚 xiū-qī joy and sorrow
杆|[gān] pole<br /><br />[gǎn] (F桿) shaft
岩|[yán] rock, cliff; 岩石 yánshí rock; 砂岩 shāyán sandstone; 熔岩 róngyán melted rock = lava
喂|[wèi] hey, hello, (=喂养 wèiyǎng) feed, raise
扔|[rēng] throw, toss; 扔球 rēngqiú throw a ball (compare with 接球 jiēqiu catch a ball)
逝|[shì] 逝世 shìshì pass away, die; 消逝 xiāoshì fade away, elapse
誕|[dàn] 诞生 dànshēng be born; 圣诞节 Shèngdànjié Christmas
懸|[xuán] hang, unresolved, worry; 悬崖 xuányá cliff
爽|[shuǎng] 爽朗 shuǎnglǎng bright, clear, frank; 凉爽 liángshuǎng pleasantly cool
崔|[cuī] {family name}>; 崔嵬 cuīwéi rocky mound, otwering; 崔巍 cuīwēi lofty, towering
廷|[tíng] royal court
湊|[còu] gather together, happen by chance
痴|[chī] idiotic; 痴心 infatuation
盆|[pén] basin, tub, pot; 盆地 péndì basin (of land)
御|[yù] imperial; (F禦) 防御 fángyù defense; 抵御 dǐyù resist
酷|[kù] (=残酷 cánkù) cruel, {slang}> cool
艾|[ài] Chinese mugwort; 艾绒 àiróng moxa<br /><br />[yì] 怨艾 yuànyì resentment
唉|[ài] {interjection indicating sentiment/sympathy/disappointment}> oh!<br /><br />[āi] yes?
姥|[lǎo] 姥姥 lǎolao {colloquial}> maternal grandmother<br /><br />[mǔ] {archaic}> old lady
籠|[lóng] (=笼子 lóngzi) cage, coop<br /><br />[lǒng] 笼罩 lǒngzhào shroud, envelop
顛|[diān] jolt, fall, summit; 颠倒 diāndǎo turn upside down
姻|[yīn] marriage; 婚姻 hūnyīn marriage, realated by marriage
攜|[xié] (携带 xiédài) carry, take along; 携手 xiéshǒu hand in hand
愧|[kuì] (惭愧 cánkuì) ashamed
芬|[fēn] fragrance; 芬芳 fēnfāng fragrant; 芬兰 Fēnlán Finland
穆|[mù] 静穆 jīngmù solemn and quiet, {family name}>; 穆罕默德 Mǔhǎnmòdé Mohammed
扇|[shàn] a fan, slap, {classifier for doors etc.}>; 一扇门 yí shàn mén<br /><br />[shān] to fan, slap, incite
郁|[yù] {family name}>; fragrant; elegant; (F鬱) luxuriant; 忧郁 yōuyù melancholy
擲|[zhì] throw, cast
怔|[zhēng] terrified, panic-stricken<br /><br />[zhèng] 發怔 fāzhèng stare blankly
芯|[xīn] rush pith<br /><br />[xìn] 岩芯 yánxìn core
鼠|[shǔ] (=老鼠 lǎoshǔ) mouse, rat; 鼠年 shūnián year of Rat = 1st year
糾|[jiū] 纠正 jiūzhèng rectify; 纠缠 jiūchán get entangled
疆|[jiāng] 边疆 biānjiāng border region; 新疆 Xīnjiāng
曰|[yuē] say<br /><br />{Compare with 日 rì sun}
傅|[fù] 师傅 shīfu master (term of respect)
袍|[páo] (=袍子 páozi) robe, gown
唇|[chún] (=嘴唇 zuǐchún) lip; 唇膏 chúngāo lipstick
穌|[sū] revive, come to; 耶稣 Yēsū Jesus
捧|[pěng] hold, carry in both hands; 捧着一个西瓜 pěngzhe yí gè xīguā carrying a watermelon
勾|[gōu] cross out, evoke, gang up with<br /><br />[gòu] 勾当 gòudang shady deal/business
牧|[mù] herd, tend; 牧场 mùchǎng grazing land, pasture; 牧民 mùmín herdsman, govern the people
儒|[rú] Confucianism, scholar; 儒家 Rújiā Confucianists; 儒林 Rúlín (Confucian) scholars
慨|[kǎi] 慷慨 kāngkǎi generous, vehement
筋|[jīn] tendon, muscle, fiber; 脑筋 nǎojīn brains, mind, head; 橡皮筋 xiàngpíjīn rubber band
柱|[zhù] pillar, post, cylinder
卑|[bēi] low, inferior, modest, humble; 卑鄙 bēibǐ base, despicable, vulgar; 卑劣 bēiliè despicable
咽|[yàn] to swallow<br /><br />[yān] pharynx<br /><br />[yè] 呜咽 wūyè sob, whimper
噸|[dūn] {loan}> ton, 〈slang〉 one thousand yuan (RMB)
蟲|[chóng] worm, insect; 爬虫 páchóng reptile; 书虫 shūchóng bookworm
繩|[shéng] (=绳子 shéngzi, =绳索 shéngsuǒ) rope, cord
廚|[chú] 厨房 chúfáng kitchen
冤|[yuān] injustice; 冤枉 yuānwang do wrong, treat unjustly
漲|[zhǎng] rise, go up<br /><br />[zhàng] swell
皺|[zhòu] to wrinkle; 皱纹 zhòuwén wrinkles
疲|[pí] 疲劳 píláo exhausted, fatigued; 疲倦 píjuàn tired
賭|[dǔ] gamble, bet
饒|[ráo] rich, plentiful, have mercy, give extra
礦|[kuàng] (=矿石 kuàngshí) ore; (矿山 kuàngshān) mine; 矿物 kuàngwù mineral
暢|[chàng] smooth, free; 舒畅 shūchàng happy, worry-free; 畅快 chàngkuài cheerfull, carefree; 畅通 chàngtōng unimpeded, unblocked
煤|[méi] coal; 煤油 méiyóu kerosene
腕|[wàn] (=手腕 shǒuwàn) wrist; 腿腕子 tuǐwànzi ankle
噴|[pēn] spurt, spray; 打喷嚏 dǎ pēntì sneeze<br /><br />[pèn] crop, in season, high season
遣|[qiǎn] 派遣 pàiqiǎn send, dispatch; 先遣 xiānqiǎn sent in advance
浩|[hào] 浩荡 hàodàng vast, mighty; 浩大 hàodà huge
翁|[wēng] old man, {family name}>
咨|[zī] 咨询 zīxún consult, seek advice from
鏢|[biāo] dartlike weapon; 保镖 bǎobiāo bodyguard
屏|[píng] 屏幕 píngmù screen<br /><br />[bǐng] 屏息 bǐngxī hold breath<br /><br />[bīng] 屏营 bīngyíng with fear and trepidation
仲|[zhòng] second, middle (of 3 months or brothers); 仲春 zhòngchūn 2nd month of spring, middle of spring; 仲兄 zhòngxiōng 2nd eldest brother
嘻|[xī] exclamation of surprise, Alas!, My! (=嘻嘻 xīxī) sound of giggling
吩|[fēn] 吩咐 fēnfù tell, instruct
棉|[mián] cotton
孟|[mèng] eldest son, first month of season, {family name}>
撐|[chēng] prop up, support, keep up, fill to bursting
爐|[lú] (=炉子 lúzi) stove, oven, furnace
泄|[xiè] leak, drain, divulge, release<br /><br />[yì] 泄沓 yìtà garrulous and disorderly, easygoing
葬|[zàng] (=埋葬 máizàng) bury (the dead); 葬礼 zànglǐ funeral
搜|[sōu] search; 搜集 sōují collect; 搜查 sōuchá search; 搜索 sōusuǒ look for
添|[tiān] add, increase
遵|[zūn] obey; 遵守 zūnshǒu comply with; 遵照 zūnzhào obey, conform to
迪|[dí] {archaic}> enlighten, guide
偽|[wěi] false, fake; 虚伪 xūwěi false, hypocritical; 伪币 wěibì counterfeit money
兆|[zhào] omen, million, mega
欠|[qiàn] owe, lack, lean forward; 哈欠 hāqiàn yawn
諒|[liàng] (=原谅 yuánliàng) forgive
炎|[yán] (=炎热 yánrè) burning hot, (=发炎 fāyán) inflammation
氛|[fēn] 气氛 qìfēn atmosphere
杖|[zhàng] cane, caning, flogging, (=手杖 shǒuzhàng) staff, walking stick
瞎|[xiā] become blind, pointlessly; 瞎子 xiāzi blind person
釣|[diào] (=钓鱼 diàoyú) to fish; 钓钩 diàogōu fishing hook
腸|[cháng] intestine
披|[pī] drape over one's shoulders, open
剝|[bāo] shell, peel<br /><br />[bō] 剥削 bōxuē exploitation
誓|[shì] (=发誓 fāshì) swear; 誓言 shìyán oath
賺|[zhuàn] gain, profit<br /><br />[zuàn] cheat
役|[yì] labor, required service, (=战役 zhànyì) battle; 兵役 bīngyì military service; 奴役 núyì enslave
泡|[pào] soak, bubble; 泡菜 pàocài pickle; 泡沫 pàomò foam<br /><br />[pāo] spongy
逆|[nì] go against, disobey, be contrary to; 汉英逆引词典 Hanyǔ nì yǐn cídiǎn Reverse Chinese-English dictionary
矮|[ǎi] short (not tall), low; 矮子 ǎizi dwarf
吊|[diào] hang, lift up, let down with rope, crane, mourn, revoke
填|[tián] fill, stuff, fill in (form)
嘉|[jiā] good, fine, praise
燭|[zhú] 蜡烛 làzhú candle
廈|[shà] 大厦 dàshà tall building, mansion<br /><br />[Xià] 厦门 Xiàmén Amoy
夕|[xī] evening, sunset; 夕阳 xīyáng the setting sun
衰|[shuāi] 衰弱 shuāiruò weak, feeble; 衰老 shuāilǎo decrepit; 衰退 shuāituì fail, decline<br /><br />[cuī] 等衰 děngcuī rank, grade
液|[yè] fluid, (=液体 yètǐ) liquid
薛|[Xuē] {family name}>
仆|[pū] fall forward; 颠仆 diānpū fall (down), fall into disgrace<br /><br />[pú] (F僕) 仆人 púrén servant
邁|[mài] step, stride, old
齒|[chǐ] (=牙齿 yáchǐ) tooth
謹|[jǐn] (=谨慎 jǐnshèn) cautious, sincerely
呈|[chéng] to present; 呈现 chéngxiàn appear; 呈报 chéngbào submit a report
昂|[áng] (=昂首 ángshǒu) hold one's head high, high, soaring
抄|[chāo] copy search and confiscate; 抄写 chāoxiě transcribe
彌|[mí] 弥漫 mímiàn fill the air; 弥补 míbǔ make up for, remedy
渴|[kě] (=口渴 kǒukě) thirsty; 渴望 kěwàng thirst for, long for
梯|[tī] (=梯子 tīzi) ladder, (=楼梯 lóutī) stairs
疏|[shū] sparse, scanty; 疏忽 shūhu carelessness
耗|[hào] (=消耗 xiāohào, =耗费 hàofèi) consume; 耗子 hàozi mouse, rat
瞪|[dèng] open (one's eyes) wide, stare, glare; 瞪眼 dèngyǎn stare, stare down
斥|[chì] 排斥 páichì reject; 驳斥 bóchì refute, denounce, reject, 斥责 chìzé denounce
誇|[kuā] brag; 夸大 kuādà exaggerate
蒂|[dì] stem of a fruid; 烟蒂 yāndì cigarette butt; 阴蒂 yīndì clitoris
剪|[jiǎn] (=剪刀 jiǎndāo) scissors
娶|[qǔ] marry (a woman), take a wife, get married
痕|[hén] 痕迹 hénjì mark, trace, vestige; 伤痕 shānghén scar
弗|[fú] {archaic}> not
姚|[Yáo] {family name}>
債|[zhài] debt
妥|[tuǒ] appropriate, ready
璃|[lí] 玻璃 bōli glass; 琉璃 liúlí coloured glaze
掏|[tāo] pull out, fish out (from pocket, etc.), dig
剎|[shā] (=刹车) brake, stop<br /><br />[chà] 刹那 chànà instant, split second
晶|[jīng] bright; 水晶 shuǐjīng (rock) crystal; 晶体管 jīngtǐguǎn transistor; 晶营 jīngyíng sparkling
衷|[zhōng] inner feelings, middle; 衷心 zhōngxīn wholehearted; 无动于衷 wú dòng yú zhōng indifferent, unconcerned
膚|[fū] (=皮肤 pífu) skin; 肤色 fūsè color of skin
鹿|[lù] deer
拓|[tà] make rubbings from stone/bronze<br /><br />[tuò] open up, develop
卓|[zhuó] tall, {family name}>, (=卓越 zhuóyuè) outstanding
癥|[zhèng] disease; 健忘症 jiànwàngzhèng amnesia<br /><br />[zhēng] 症结 zhēngjié crucial reason, obstruction of the bowels
糖|[táng] sugar, (=糖果 tángguǒ) candy; 糖醋 tángcù sweet and sour
欽|[qīn] by the emperor himself, respect, (=钦佩 qīnpèi) admire; 钦差 qīnchāi imperial envoy
綿|[mián] 连绵 unbroken; 海绵 sponge<br /><br />[miān] 软绵绵 soft
哩|[lī] {used as for sound value}><br /><br />[lǐ] (=英里 Yīnglǐ) Britittish mile
誘|[yòu] guide, lead, lure
枯|[kū] withered, dried up, dull
歇|[xiē] have a rest; 间歇 jiànxiē intermission
塑|[sù] model, mould; 塑料 sùliào plastic; 塑像 sùxiàng statue
妨|[fáng] (=妨碍 fáng'ài) hinder, impede, harm; 不妨 bùfáng might as well, no harm in...
豫|[yù] short name for Henan; 犹豫 yóuyù hesitate
抑|[yì] press down, restrain; 抑制 yìzhì restrain, inhibition
珊|[shān] 珊瑚 shānhú coral; 珊瑚礁 shānhújiāo coral reef
棍|[gùn] (棍子) rod, stick; 拐棍 guǎigùn walking stick
晉|[jìn] enter, advance, promote, a dynasty (265-420), {family name}>, short name for Shanxi province
淋|[lín] pour, drench; 冰淇淋 bīngqilín ice cream<br /><br />[lìn] strain, filter<br /><br />[līn] 湿淋淋 shīlīnlīn drenched
悅|[yuè] (=喜悦 xǐyuè) happy, joyful, delighted
敦|[dūn] 敦厚 dūnhòu honest, sincere; 敦煌 Dūnhuáng (in Gansu)<br /><br />[duì] ancient vessel
艷|[yàn] beauteous, amorous, (=艳丽 yànlì) gorgeous, respendent; 鲜艳 xiānyàn bright (color)
玻|[bō] 玻璃 bōli glass
砸|[zá] strike, smash, break
嚷|[rǎng] shout, yell<br /><br />[rāng] 嚷嚷 rāngrang shout
盲|[máng] (=盲目 mángmù) blind, unable to distinguish; 盲动 mángdòng act blindly
辨|[biàn] distinguish, differentiate
葛|[gé] kudzu vine, grass-cloth<br /><br />[Gě] {family name}>
罕|[hǎn] rarely, seldom<br /><br />[han] 希罕 xīhan rare, cherish
矩|[jǔ] (carpenter's square); 矩阵 jǔzhèn matrix
泳|[yǒng] 游泳 yóuyǒng swim
宅|[zhái] residence, house
貸|[dài] borrow, (=贷款 dàikuǎn) lend, loan
膀|[bǎng] upper arm, (=肩膀 jiānbǎng) shoulder; 翅膀 chìbǎng wing;<br /><br />[pāng] swell<br /><br />[páng] 膀胱 pángguāng urinary bladder
捏|[niē] hold between the fingers, knead, fabricate
頸|[jǐng] (=颈项 jǐngxiàng) neck<br /><br />[gěng] 脖颈儿 bógěngr nape
踐|[jiàn] 实践 put into practice; 践踏 trample
脖|[bó] (=脖子 bózi) neck
賈|[gǔ] merchant<br /><br />[Jiǎ] {family name}>
轎|[jiào] sedan chair; 轿车 jiàochē car
脾|[pí] spleen; 脾气 píqi (bad-) temper
堡|[bǎo] (=堡垒 bǎolěi), fort, fortress; 城堡 chéngbǎo castle<br /><br />[bǔ] (=堡子 bǔzi) walled town/village (used mostly in place names)<br /><br />[pù] walled town/village (used mostly in place names)
嬌|[jiāo] graceful, delicate; 娇嫩 jiāonèn tender and lovely
浙|[Zhè] 浙江省 Zhèjiāngshěng Zhejiang Province
劣|[liè] bad, inferior, minor
瀟|[xiāo] deep and clear water; 潇洒 xiāosǎ natural & unrestrained
賜|[cì] give, grant, gift (from superior to inferior)
陀|[tuó] 陀螺 tuóluó top (spiraling toy); 陀螺仪 tuóluóyí gyroscope
蓄|[xù] store, save, grow; 积蓄 jīxù save; 储蓄 chǔxù deposit
墳|[fén] grave, tomb
頌|[sòng] praise, song, ode; 歌颂 gēsòng sing the praises of
漏|[lòu] (=漏水 lòushuǐ) leak out
杭|[Háng] 杭州 Hángzhōu
茅|[máo] straw, thatch; (茅草 máocǎo) grass for thatching; 白茅 báimáo edible wild grass
磚|[zhuān] brick
瞬|[shùn] wink; 瞬间 shùnjiān a moment, in the twinkling of an eye
鶴|[hè] crane (emblem of longevity)
辟|[bì] monarch; 复辟 fùbì restore a dethored monarch or old order<br /><br />[pì] 开辟 kāipì open up, start
漁|[yú] to fish; 渔民 yúmín fisherfolk; 渔业 yúyè fishery
乖|[guāi] clever, (=乖乖 guāiguāi) obedient, well-behaved
霸|[bà] overlord, tyrant, dominate; 霸占 bàzhàn sieze
襄|[xiāng] (=襄助 xiāngzhù) assist, help
炒|[chǎo] stir fry, saute; 炒饭 chǎofàn fried rice; 炒面 chǎomiàn "chow mein", fried noodles
啞|[yǎ] mute, dumb, hoarse<br /><br />[yā] {interjection indicating surprice, same as 呀}>, ah, oh
浦|[pǔ] riverside, river mouth (mostly used in place names), {family name}>
餅|[bǐng] cake; 饼干 bǐnggān cracker, cookie
犧|[xī] sacrificial animal; 牺牲 xīshēng sacrifice
灘|[tān] (=海滩 hǎitān) beach, sands
釘|[dīng] a nail, to follow closely<br /><br />[dìng] to nail
吁|[yù] plead, (=呼吁 hūyù) appeal<br /><br />[xū] 吁吁 xūxū panting, puffing hard<br /><br />[yū] {interjection "Whoa!"}>
錫|[xī] tin (Sn)
贈|[zèng] (=赠送 zèngsòng) give as a present
哄|[hōng] hubbub<br /><br />[hǒng] fool, coax<br /><br />[hòng] horseplay
鈴|[líng] bell
頑|[wán] stupid, stubborn, naughty; 顽强 wánqiáng indomitable; 顽固 wángù obstinate
殖|[zhí] propagate, (=繁殖 fánzhí) breed, reproduce, colonize; 殖民地 zhímíndì colony<br /><br />[shi] 骨殖 gǔshi skeleton
鷹|[yīng] hawk, eagle
蔡|[Cài] {family name}>, sacrificial tortoise
催|[cuī] urge, hurry, hasten
芙|[fú] 芙蓉 fúróng cottonrose hibiscus, lotus
彬|[bīn] 彬彬 bīnbīn {archaic}> refined, urbane
拚|[pīn] (= 拼) put/piece together, spell, risk life<br /><br />[pàn] abandon and ignore
軌|[guǐ] track, rail, course, path; 轨道 guǐdào orbit
喲|[yō] Oh!<br /><br />[yo] {interjection indicating exhortation}><br /><br />[yāo] ouch
歉|[qiàn] apology; 道歉 dàoqiàn apologize; 抱歉 bàoqiàn regret, be sorry
盯|[dīng] stare at
碩|[shuò] very large; 硕士学位 shuòshìxuéwèi Master's degree
惹|[rě] offend, ask for (trouble); 惹麻烦 rě máfán excite or invite trouble
契|[qì] (=契约 qìyuē) contract, legal agreement<br /><br />[qiè] 契阔 qièkuò long separation, to be separated from one another
愚|[yú] make a fool of, dupe, (=愚蠢 yúchǔn) foolish, stupid
帥|[shuài] commander in chief, graceful
惶|[huáng] afraid, fearful, (=惶恐 huángkǒng) alarmed, anxious, uneasy, (= 忧惶 yōuhuáng, (= 惶惑 huánghuò) apprehensive; 惊惶 scared, alarmed
憾|[hàn] (=遗憾 yíhàn) regret, sorry
懶|[lǎn] lazy, sluggish; 伸懒腰 shēn lǎnyāo stretch oneself
姨|[yí] aunt (mother's sister), sister-in-law (wife's sister)
喘|[chuǎn] (=喘气 chuǎnqì) pant, gasp for breath; 气喘 qìchuǎn asthma
獸|[shòu] beast, wild animal, (=野兽 yěshòu) beastly, crude, uncivilized
陌|[mò] path between fields, (=陌生 mòshēng) strange; 陌生人 mòshēngrén stranger
罩|[zhào] cover, hood, overalls, cage
獵|[liè] (=打猎 dǎliè) hunt, chase; 猎人 lièren hunter; 猎狗 liègǒu hound
嵩|[sōng] lofty (mountain); 嵩山 Sōngshān mountain in Hénán
鹽|[yán] salt
飢|[jī] starve, be hungry, famine; 饥饿 jī'è hunger, starvation
凄|[qī] cold, chilly, sad; 凄凉 qīliáng desolate; 凄惨 qīcǎn wretched
喉|[hóu] (=喉咙 hóulóng) throat, larynx
宴|[yàn] (=宴会 yànhuì) banquet
腔|[qiāng] cavity, tune, pitch, accent, speech
翰|[hàn] writing brush, writing
膝|[xī] (=膝盖 xīgài) knee
陵|[líng] hill, mound, tomb; 十三陵 Shísānlíng the 13 Ming tombs
蜂|[fēng] bee, wasp; 蜜蜂 mìfēng honeybee; 蜂房 fēngfáng beehive
邏|[luó] patrol; 逻辑 luóji {loan}> logic
劈|[pī] chop, split<br /><br />[pǐ] divide, split
廉|[lián] honest, clean, low-priced
裹|[guǒ] bind, wrap; 包裹 bāoguǒ bundle, package
驕|[jiāo] severe, (=骄傲 jiāo'ào) arrogant, proud
販|[fàn] 贩子 fànzi dealer; 贩卖 fànmài deal in, traffic, peddle
繪|[huì] paint, draw; 绘画 huìhuà drawing, painting
崖|[yá] (=崖壁 yábì) precipice, cliff
辰|[chén] time, day, occasion, celestial bodies, 2-hr period; 星辰 xīngchén star
涯|[yá] 天涯 tiānyá edge of world; 生涯 shēngyá career, profession
戈|[gē] ancient Chinese weapon similar to dagger axe or halberd
坑|[kēng] hole, pit
遮|[zhē] cover, hide, block
擒|[qín] capture, catch, seize
蠻|[mán] quite, very, fierce, (=野蛮 yěmán) barbaric; 蛮横 mánhèng unreasonable
芷|[zhǐ] 白芷 báizhǐ {Chinese medicine}> root of Dahurian Angelica
堵|[dǔ] stop up, block, {classifier for walls}>, {family name}>; 一堵墙 yì dǔ qiáng a wall
雇|[gù] (=雇佣 gùyōng) hire, employ; 雇主 gùzhǔ employer; 雇员 gùyuán employee
挽|[wǎn] draw, pull, roll up; 挽救 wǎnjiù rescue; (F輓) pull (cart/carriage); lament
眠|[mián] (睡眠 shuìmián) sleep; 冬眠 dōngmián hibernate
吻|[wěn] kiss, animal's mouth, muzzle, lips
孝|[xiào] filial, filial piety, mourning
泊|[bó] at anchor, moor, berth<br /><br />[pō] 湖泊 húpō lakes
撕|[sī] rip, tear; 撕毁 sīhuǐ tear apart<br /><br />[xī] 提撕 tíxī arouse attention, help and guide
虹|[hóng] (=彩虹 cǎihóng) rainbow<br /><br />[jiàng] {colloquial}> rainbow
敘|[xù] chat, (=叙述 xùshù, =叙事 xùshì) narrate, relate
粹|[cuì] (=纯粹 chúncuì) pure, unadulterated
勉|[miǎn] make an effort; 勉强 miǎnqiǎng force; with difficulty
竭|[jié] (=竭力 jiélì) do one's utmost, (=竭尽 jiéjìn) use up, exhaust
歪|[wāi] crooked, askew, inclined, devious
慎|[shèn] cautious, careful
棵|[kē] {classifier for trees, cabbages, etc.}>; 一棵树 yí kè shù a tree
朴|[pǔ] (F樸) (=朴素 pǔsù) simple<br /><br />[Piáo] {family name}><br /><br />[pò] 朴树 pòshù Chinese hackberry<br /><br />[pō] 朴刀 pōdāo a type of long knife
械|[xiè] machinery, (=机械 jīxiè) mechanical; 器械 qìxiè apparatus
溪|[xī] (=溪流 xīliú) brook, small stream
莉|[lì] 茉莉 mòli jasmine; 茉莉花茶 mòli huāchá jasmine tea
斑|[bān] spot, speck, stripe; 斑马 bānmǎ zebra
磕|[kē] knock against; 磕头 kētóu kowtow; 磕碰 kēpèng collide with
寡|[guǎ] few, scant, tasteless; 寡妇 guǎfu widow; 沉默寡言 chénmòguǎyán habitually silent
循|[xún] follow, abide by; 循环 xúnhuán circulate, cycle
斬|[zhǎn] chop
掠|[lüè] take by force, (=掠夺 lüèduó) pillage, plunder; (掠过 lüèguò) sweep past<br /><br />[lüě] sweep/brush past, snatch away
呂|[Lǚ] {family name}>
昔|[xī] (=昔日 xīrì) former times, the past; 往昔 wǎngxī in the past
郊|[jiāo] (=郊区 jiāoqū, =郊外 jiaowài) suburbs, outskirts
爵|[jué] rank of nobility, peerage; 爵士 juéshì knight; 爵士音乐 juéshì yīnyuè jazz
徽|[huī] emblem, badge, insignia; 安徽省ānhuī shěng Anhui Province
磁|[cí] magnetism; 磁铁 cítiě magnet; 磁带 cídài (magnetic) tape
俯|[fǔ] bow (one's head), bend down; 俯冲 fǔchōng dive; 俯瞰 fǔkàn look down at, overlook
譚|[tán] talk, {family name}>; 天方夜谭 tiānfāngyètán the story of Arabian Nights
鼎|[dǐng] ancient cooking vessel, tripod
拂|[fú] stroke, touch lightly, whisk, flick, go against (somebody's wishes); 拂晓 fúxiǎo before daybreak<br /><br />[bì] (=弼) assist
俺|[ǎn] I, we; 俺们 ǎnmen we (refers to speakers only)
嫂|[sǎo] (=大嫂 dàsǎo) elder brother's wife, sister-in-law
帕|[pà] kerchies, (=手帕 shǒupà) handkerchief
嗯|[ńg] What?, Huh?<br /><br />[ňg] How come?, Why?<br /><br />[?g] O.K., Agreed!
凍|[dòng] freeze
婉|[wǎn] gentle, (=婉转 wǎnzhuǎn) tactful, agreeable
桐|[tóng] parasol tree; 桐油 tóngyóu tung oil
駱|[luò] (=骆驼 luòtuo) camel
潑|[pō] splash, spoll, sprinkle; rude and unreasonable; 活泼 huópo lively
匠|[jiàng] artisan<br /><br />[jiang] 木匠 mùjiang carpenter; 铁匠 tiějiàng blacksmith
艇|[tǐng] light boat
謙|[qiān] 谦虚 qiānxū, 谦逊 qiānxùn modest
妓|[jì] (=娼妓 chāngjì) prostitute, {traditional}> female performer
菩|[pú] 菩萨 púsà bodhisattva, benevolent being
廁|[cè] (=厕所 cèsuǒ) toilet<br /><br />[si] (=茅厕 máosi) latrine
俘|[fú] capture, (=俘虏 fúlǔ) prisoner, captive
毅|[yì] resolute; 毅力 yìlì willpower; 坚毅 jiānyì determined
嶺|[lǐng] mountain, (=山岭 shānlǐng) mountain range, ridge; 峻岭 jùnlǐng high mountains
丫|[yā] fork, bifurcation; 丫头 yātou girl, maid, servant, salve girl
畏|[wèi] fear, respect; 畏惧 wèijù dread; 畏缩 wèisuō flinch
湘|[Xiāng] short name for 湖南 Húnán; 湘江 Xiāng Jiāng a river in Hunan
桶|[tǒng] bucket
嗓|[sǎng] (=嗓子 sǎngzi) throat, (=嗓音 sǎngyīn) voice, (=嗓门儿 sǎngménr) larynx, voice
煌|[huáng] bright, brilliant; 敦煌石窟 Dūnhuáng Shíkū Gansu Caves
鮑|[bào] {family name}>, (=鲍鱼 bàoyú) abalone
粒|[lì] grain, granule; 粒子 lìzǐ {terminology in physics}> particle
巷|[xiàng] lane, alley<br /><br />[hàng] 巷道 hàngdào tunnel (in a mine)
帘|[lián] flag as shop sign; (F簾) curtain
禿|[tū] bald, bare, blunt, incomplete
腊|[là] (F臘) (=腊月 làyuè) 12th lunar month, cured (fish/meat/etc.); 腊肠 làcháng sausage; 希腊 Xīlà Greece<br /><br />[xī] dried meat
倉|[cāng] warehouse
拐|[guǎi] (=拐弯 guǎiwān) turn, change direction, limp, swindle, abduct; 拐棍 guǎigùn walking stick
綁|[bǎng] bind, tie; 绑架 bǎngjià kidnap
啥|[shá] (=啥子 sházi) what? (= 什么 shénme)
薦|[jiàn] recommend, {archaic}> grass, straw
倪|[ní] {family name}>, (=端倪 duānní) clue
瑟|[sè] musical instrument with 25 strings
廊|[láng] hall
鴨|[yā] (=鸭子 yāzi) duck; 唐老鸭 Táng lǎoyā Donald Duck
蜜|[mì] (=蜂蜜 fēngmì) honey; 蜜蜂 mìfēng honeybee
診|[zhěn] 诊断 zhěnduàn diagnose; 诊所 zhěnsuǒ clinic
棚|[péng] shed, shack, canopy; 窝棚 wōpeng shack
掀|[xiān] lift (a cover, etc.), surge
筒|[tǒng] tube; 电筒 diàntǒng flashlight
媳|[xí] (=媳妇 xífù) daughter-in-law; 童养媳 tóngyǎngxí child bride
紋|[wén] lines, veins, (wood) grain
秒|[miǎo] second (1/60 of a 分 minute)
沾|[zhān] moisten, soak, touch
龐|[páng] (=庞大 pángdà) colossal, huge
蹲|[dūn] squat on the heels, stay
騷|[sāo] (=骚动 sāodòng, =骚乱 sāoluàn) disturb, harass
歧|[qí] (of roads:) fork, branch, divergent; 歧视 qíshì discriminate
艘|[sōu] {classifier for boats, vessels, etc.}>; 两艘油船 liǎng sōu yóuchuán two oil tankers
芝|[zhī] {traditional}> iris; 哗芝麻 zhīma sesame
嘩|[huá] clamor, hubbub, (=喧哗 xuānhuá) noise, clamor<br /><br />[huā] {the sound of clanging, gurgling, etc.}>
畝|[mǔ] sixth of an acre (0.0667 hectares)
券|[quàn] ticket, certificate; 入场券 rùchǎngquàn admission ticket<br /><br />[xuàn] 拱券 gǒngxuàn span of an arch
趟|[tàng] {classifier for trips, times, rows, etc.}><br /><br />[tāng] (=蹚 tāng) ford, wade
巾|[jīn] piece of cloth; 毛巾 máojīn towel; 餐巾 cānjīn napkin; 围巾 wéijīn scarf
淫|[yín] excessive, over, wanton, lewd, licentious
謊|[huǎng] lie, prevaricate
寞|[mò] quiet; 寂寞 jìmò lonely
灌|[guàn] pour; 灌溉 guàngài irrigate; 灌木 guànmù bush
籃|[lán] basket; 篮球 lánqiú basketball
妄|[wàng] absurd, rash; 妄想狂 wàngxiǎngkuáng paranoia
擱|[gē] put<br /><br />[gé] endure
侄|[zhí] brother's son, nephew; 侄女 zhúnǚ brother's daughter, neice
廂|[xiāng] wing of a house, side, railway carriage
叉|[chā] (=叉子 chāzi) fork, intersection, (=交叉 jiāochā) intersect<br /><br />[chá] obstruct, jam up<br /><br />[chǎ] the distance between thumb and middle minger on an outstretched hand<br /><br />[chà] fork, diverge; 叉路 chàlù crossroad
俞|[Yú] {family name}>, small boat<br /><br />[shù] (=腧)
伐|[fá] fell, cut down, attack
宰|[zǎi] slaughter, butcher, govern; 宰割 zǎigē invade and oppress
瞞|[mán] hide the truth from
宙|[zhòu] 宇宙 yǔzhòu cosmos
腫|[zhǒng] swollen; 肿瘤 zhǒngliú tumor; 红肿 red and swollen
漆|[qī] lacquer, paint; 油漆 yóuqī paint; 漆黑 qīhēi pitch-black
怖|[bù] fear, frightening; 恐怖 kǒngbù terror
吾|[wú] (=予 yǔ) {archaic}> I, me
吼|[hǒu] roar, howl
僑|[qiáo] 华侨 Huáqiáo overseas Chinese; 侨胞 compatriots abroad
疊|[dié] pile up, repeat; (折叠 zhédié) fold
嘯|[xiào] 呼啸 hūxiào whistle, scream, whizz
罐|[guàn] (罐头 guàntou) can; jar
肆|[sì] (=四sì) four, (=肆意 sìyì) wantonly, {archaic}> shop
裙|[qún] (裙子 qúnzi) skirt
泣|[qì] (=哭泣 kūqì) cry, weep, (=抽泣 chōuqì) sob
脹|[zhàng] (=膨胀 péngzhàng) swell, expand
賦|[fù] (赋于) bestow on; compose; 赋税 taxes
熬|[áo] boil, stew; endure<br /><br />[āo] boil, cook in water
趁|[chèn] take advantage of; while; 趁机会 chèn jīhuì take advantage of an opportunity
咳|[hāi] hey<br /><br />[ké] 咳嗽 késou cough
愉|[yú] 愉快 yúkuài delighted
懇|[kěn] 诚恳 chéngkěn, 恳切 kěnqiè sincere; 恳求 plead
辜|[gū] 辜负 gūfù let down, disappoint
肌|[jī] 肌肉 jīròu muscle
嬰|[yīng] (=婴儿 yīng'ér) baby, infant
羽|[yǔ] (=羽毛 yǔmáo) feather; 羽毛球 yúmáoqiú badminton
躬|[gōng] {archaic}> personally; bend at the waist
斃|[bì] execute (kill); 枪毙 qiāngbì execute by shooting
拘|[jū] (=拘留 jūliú) arrest, detain; 拘束 jūshù restrict; 拘谨 jūjiň overcautious
叮|[dīng] sting, bite; say/ask again, verify
哇|[wa] {sentence final particle like 啊 a}><br /><br />[wā] wah! (sound of crying)
晴|[qíng] (晴朗 qínglǎng) fine, sunny; 晴天霹雳 qíngtiānpīlì a bolt from the blue
謎|[mí] (谜语 míyǔ) riddle<br /><br />[mèi] 谜儿 riddle
淮|[Huái] a river in 河南 and 安徽
旺|[wàng] prosperous, flourishing; 旺盛 vigorous, exuberant
逸|[yì] leisure, escape; 安逸 ānyì comfortable, leisurely
瓊|[qióng] beautiful jade; 琼脂 agar
姜|[jiāng] ginger
嗚|[wū] (sound of whistling, zooming); 呜咽 wūyè sob, whimper
竄|[cuàn] flee, scurry; exile; change wording
頒|[bān] proclaim, (=颁发 bānfā) promulgate, issue
薪|[xīn] firewood, fuel, (=薪水 xīnshui) salary
寨|[zhài] stockade, camp
尿|[niào]<br /><br />[suī] urine, urinate
頰|[jiá] jaw; cheek
逮|[dài] 逮捕 dàibǔ arrest<br /><br />[dǎi] catch; 猫逮老鼠 māo dǎi lǎoshǔ a cat catching a mouse
卜|[bǔ] fortune telling<br /><br />[bo] 胡萝卜 húluóbo carrot
昭|[zhāo] clear, obvious; 昭雪 zhāoxuě rehabilitate
浸|[jìn] soak
刮|[guā] scrape; 刮胡子 guā húzi shave; (F颳) (wind) blow<br /><br />[kā] 刮吃 kāchi 〈colloquial〉 scrape, sponge on
宛|[wǎn] 宛如 wǎnrú just like; 宛然 wǎnrán as if; [yuān] 大宛
囑|[zhǔ] (=嘱咐 zhǔfu) advise, enjoin, urge, exhort
囊|[náng] bag; 鼓鼓囊囊 gǔgunāngnāng bulging<br /><br />[nāng] 囊膪 nāngchuài pork near the pig's nipples
寓|[yù] reside, live; 寓所 yùsuǒ residence; 寓言 fable, allegory
駁|[bó] contradict; 驳斥 bóchì denounce; 反驳 fǎnbó refute
倡|[chàng] 倡议 chàngyì propose<br /><br />[chāng] 倡优 chāngyōu entertainer
浴|[yù] (=沐浴 mùyù) take a bath; 浴室 yùshì bath/shower room
咕|[gū] coo, cluck (bird sounds)
挪|[nuó] (挪动 nuódong) move; remove
搏|[bó] 搏斗 bódòu fight, wrestle; 脉搏 màibó pulse
蓬|[péng] bitter fleabane, (=蓬松 péngsōng) fluffy, {classifier for clumps of bamboo, grass, etc.}>; 蓬勃 péngbó vigorous
晌|[shǎng] part of the day; noon
渠|[qú] canal, ditch, channel; 渠道 irrigation ditch
兜|[dōu] pocket, bag
喃|[nán] 喃喃 nánnán mutter
夷|[yí] {archaic}> smooth; wipe out, raze
滬|[Hù] name for 上海 Shanghai
賤|[jiàn] inexpensive, cheap, lowly, humble, worthless
魄|[pò] 气魄 qìpò boldness<br /><br />[bó] 落魄<br /><br />[tuò] 落魄
舵|[duò] rudder; helm; 舵手 steersman, helmsman
晰|[xī] 清晰 qīngxī clear, distinct
僵|[jiāng] stiff; numb; deadlocked; 僵硬 stiff, rigid
糕|[gāo] pudding, (=蛋糕 dàngāo) cake
裔|[yì] {archaic}> descendents, posterity; borderland
秩|[zhì] 秩序 zhìxù order, sequence
倚|[yǐ] (倚靠 yǐkào) lean on; rest against; rely on
塌|[tā] collapse; sink; calm down
恍|[huǎng] suddenly, as if
鉤|[gōu] (钩子 gōuzi) hook
嘲|[cháo] 嘲笑 cháoxiào ridicule, laugh at; 嘲讽 cháofěng sneer at, taunt, mock; 嘲弄 cháonòng mock, deride
傍|[bàng] be close to; 傍晚 bàngwǎn toward evening, at nightfall
裕|[yù] abundant, affluent; 富裕 fùyù rich, wealthy, opulent
煮|[zhǔ] boil, cook
乳|[rǔ] milk, breast; 哺乳 bǔrǔ breast-feed; 乳酪 rǔlào cheese
勿|[wù] do not!
豎|[shù] vertical, perpendicular; vertical stroke "丨"
懲|[chéng] chastise, punish, correct, repress; restrain oneself
睹|[dǔ] look at, observe; 目睹 mùdǔ see with one's own eyes
株|[zhū] tree-trunk; 守株待兔 shǒuzhūdàitù guarding a tree-trunk to wait for a rabbit
繡|[xiù] embroider; 绣像 embroidered portrait
妖|[yāo] (妖魔 yāomó) demon; 妖娆 yāoráo charming, enchanting
訝|[yà] 惊讶 amazed
咖|[kā] (used in transliterations) 咖啡 kāfēi coffee<br /><br />[gā] 咖喱 gālí curry
綱|[gāng] fishing net rope; guiding principle; 纲领 program
胎|[tāi] foetus, birth, (=轮胎 lúntāi) tire (of a wheel)
濱|[bīn] 海滨 seashore; 滨临 bīnlín to be close to (a body of water)
耕|[gēng] to plough, till
嗤|[chī] sneer
艙|[cāng] (ship) cabin
娛|[yú] 娱乐 yúlè amuse, amusement, recreation
匪|[fěi] (=土匪 tǔfěi) bandit, brigand, robber; 匪徒 fěitú gangster
鴉|[yā] 乌鸦 wūyā crow; 鸦片 yāpiàn opium
胃|[wèi] stomach; 胃口 wèikǒu appetite
躁|[zào] rash, impetuous
獅|[shī] (=狮子 shīzi) lion
砰|[pēng] bang (sound)
妮|[nī] 妮儿 nīr girl
凜|[lǐn] cold; strict; afraid; shiver, tremble with cold or fear
龜|[guī] (乌龟) tortoise; 海龟 turtle<br /><br />[jūn] 龟裂 jūnlì fissure (of parched earth)<br /><br />[Qiū] 龟兹 Qiūcí Kucha, a historic town at the northern rim of the Taklamakan Desert
裸|[luǒ] 裸体 luǒtǐ nude; 赤裸裸 stark-naked; 裸露 exposed
嫣|[yān] handsome, beautiful; 嫣红 bright red
甫|[fǔ] {archaic}> only, curtesy name
窯|[yáo] kiln; (窑洞) cave dwelling
塘|[táng] dike, (=池塘 chítáng, =水塘 shuǐtáng) pool
纖|[xiān] 纤维 fiber<br /><br />[qiàn] rope for towing boat
寵|[chǒng] love, bestow favor on
鏈|[liàn] (链子 liànzi) chain; 拉链 zipper; 铰链 hinge
拱|[gǒng] arch, cup one hand in other before chest, push with no hands
尹|[yǐn] ancient title for government official; (surname)
掘|[jué] dig, excavate
壩|[bà] dam; dyke, embankment
狹|[xiá] (=狭窄 xiázhǎi, =狭隘 xiá'ài) narrow
銘|[míng] engrave, carve; 铭刻 míngkè inscription, engrave on one's mind 头
淳|[chún] 淳朴 chúnpǔ honest, simple, unsophisticated
沐|[mù] wash one's hair; 沐浴 mùyù bathe
馨|[xīn] pervasive fragrance
潘|[Pān] {family name}>
甩|[shuǎi] swing back and forth, toss, get rid of, leave behind<br /><br />{Compare with 用 yòng use}
榜|[bǎng] posted list of names, announcement, notice; 榜样 example, model<br /><br />[bàng] (=搒) oar, whip, rod
淵|[yuān] 深渊 shēnyuān abyss
羡|[xiàn] 羡慕 xiànmù envy, admire
侮|[wǔ] 侮辱 wǔrǔ insult, humiliate
卿|[qīng] minister or high official in ancient times
兀|[wù] (书) towering; bald
喧|[xuān] 喧闹 make noise; 喧呼 xuānhū shout loudly
履|[lǚ] shoes
猴|[hóu] (=猴子 hóuzi) monkey
枉|[wǎng] crooked; pervert; 冤枉 yuānwang do wrong, treat unjustly
襯|[chèn] line, to place underneath, lining; 衬衫 chènshān shirt
畔|[pàn] border of a field; shore, side, bank
凳|[dèng] stool, bench; 板凳
緬|[miǎn] remote, long ago; 缅甸 Miǎndiàn Burma
弦|[xián] string of musical instrument
畜|[xù] (=畜牧 xùmù) raise (domestiv animals)<br /><br />[chù] 畜生 chùsheng beast
粞|[xī] smashed rice
溢|[yì] overflow; 洋溢 yángyì be permeated with
摟|[lǒu] hug; drag, pull<br /><br />[lōu] hold in the arms
乞|[qǐ] 乞丐 qǐgài beggar; 乞讨 qǐtǎo beg
旬|[xún] a period of ten days; 上旬 shàngxún first ten days of a month
縛|[fù] tie up, bind
燦|[càn] 灿烂 cànlàn splendid, magnificent
輿|[yú] chariot; area; 舆论 yúlùn public opinion
雁|[yàn] 大雁 dàyàn wild goose
倦|[juàn] (=疲倦 píjuàn) tired, weary
酬|[chóu] reward, payment; 酬谢 chóuxiè thank with a gift; 报酬 bàochou reward
韻|[yùn] tone, charm, appeal, (=押韵 yāyùn) rhyme; 韵文 yùnwén verse
媚|[mèi] 妩媚 wǔmèi lovely; 明媚 radiant and enchanting
堤|[dī] dyke; (堤岸 dī'àn) embankment
攀|[pān] climb; pull down; 攀登 pāndēng clamber up
竊|[qiè] 窃听 qiètīng eavesdrop; 盗窃 dàoqiè steal
嫩|[nèn] tender, delicate, light, inexperienced
遂|[suì] satisy, fulfil, succeed; 遂心 suìxīn fulfill one's desire<br /><br />[suí] 半身不遂 bànshēnbùsuí parlysis in half the body
澄|[chéng] 澄清 transparent, clear<br /><br />[dèng] settle<br /><br />[dēng] 黄澄澄 huángdēngdēng glistening yellow, golden
偵|[zhēn] 侦察 scout, reconnoitre; 侦探 detective
陝|[Shǎn] 陕西省 Shǎnxīshěng Shaanxi Province
陋|[lòu] 丑陋 chǒulòu ugly
笨|[bèn] stupid; clumsy; cumbersome; 笨重 heavy, cumbersome
匙|[shi] 钥匙 yàoshi key<br /><br />[chí] spoon
沫|[mò] (=沫儿 mòr) foam, froth; 泡沫 pàomò foam, froth; 唾沫 tuòmo saliva
聳|[sǒng] towering, lofty; alarm, shock; 高耸 gāosǒng stand tall
踩|[cǎi] step
醬|[jiàng] sauce, paste, jam; 酱油 jiàngyóu soy sauce; 花生酱 huāshēngjiàng peanut butter
壺|[hú] kettle, pot, bottle
啡|[fēi] 咖啡 kāfēi coffee
碌|[lù] 骨碌 roll; 忙碌 busy; 碌碌 mediocre<br /><br />[liù] 碌碡<br /><br />[lū]
癢|[yǎng] itch
鄙|[bǐ] I, me, my, vulgar; 鄙视 bǐshì despise, disdain
殼|[ké] shell, case<br /><br />[qiào] shell, hard surface
貞|[zhēn] (坚贞, 忠贞) loyal; virgin; ancient fortune-telling
霉|[méi] mold, mildew; 倒霉 dǎoméi have bad luck
蠢|[chǔn] (愚蠢 yúchǔn) stupid
蘆|[lú] 芦苇 lúwěi reed; 葫芦 húlu gourd<br /><br />[lǔ]
胳|[gē] 胳膊 gēbo arm; 胳臂 gēbei arm<br /><br />[gé] 胳肢 tickle<br /><br />[gā]
矣|[yǐ] {grammatical particle similar to "了"}>
焰|[yàn] 火焰 huǒyàn flame
脊|[jí] 脊梁骨 jílianggǔ backbone<br /><br />[jǐ] 屋脊 wūjǐ ridge of roof
囚|[qiú] 囚禁 qiújìn imprison; 囚犯 qiúfàn prisoner
輔|[fǔ] assist, complement; 辅导 fǔdǎo coach, tutor; 辅助 fǔzhù assist, auxiliary; 辅音 fǔyīn consonant
賬|[zhàng] account, credit, debt
佐|[zuǒ] assist
僚|[liáo] (=官僚 guānliáo) official, (=同僚 tóngliáo) colleague
雀|[què] sparrow<br /><br />[qiāo] 雀子 qiāozi freckle<br /><br />[qiǎo] 雀盲眼 qiǎomangyǎn night blindness
撰|[zhuàn] write, compose
耍|[shuǎ] play (role/tricks/etc.), play with, gamle, make fun of, {family name}>
枕|[zhěn] (枕头) pillow
撿|[jiǎn] pick up, gather, collect
涵|[hán] (涵洞) culvert; 涵养 hányǎng self-control; conserve
逗|[dòu] stop, pause, tease, play with
糞|[fèn] excrement, manure
朦|[méng] 朦胧 ménglóng dim moonlight, obscure
肝|[gān] liver
蒸|[zhēng] evaporate, (=蒸汽 zhēngqì) steam
濫|[làn] (=泛滥 fànlàn) overflow, flood; 滥用 lànyòng abuse
筷|[kuài] (筷子) chopsticks
潰|[kuì] (dam) burst; break through; 崩溃 collapse; 溃疡 ulcer<br /><br />[huì]
隸|[lì] 奴隶 núlì slave; 隶书 lìshū official script
烤|[kǎo] bake, roast, toast
缸|[gāng] jar, vat
弓|[gōng] bow; bend; 弓箭 gōngjiàn bow and arrow
潭|[tán] deep pool, pond
曠|[kuàng] vast; to waste time; 旷野 wilderness
哎|[āi] (interjection:) hey; 哎呀 āiyā; 哎哟 āiyō<br /><br />[ēi]
峻|[jùn] 严峻 yánjùn stern; 峻岭 jùnlǐng high mountains
爪|[zhǎo] claw, talon<br /><br />[zhuǎ] 爪子 claw, paw, talon
怯|[qiè] (胆怯 dǎnqiè) timid; cowardly; 羞怯 xiūqiè shy
茂|[mào] profuse, (=茂盛 màoshèng) luxuriant; 茂密 màomì dense
芒|[máng] awn, beard, arista, spike, sharp point<br /><br />[wáng] 麦芒 màiwáng awn of wheat
肢|[zhī] 肢体 zhītǐ limbs; 四肢 the Four Limbs; 前肢 forelimb
稻|[dào] growing rice, paddy
兔|[tù] (兔子 tùzi) rabbit
圾|[jī] 垃圾 lājī refuse, garbage<br /><br />[sè] 垃圾 lèsè refuse, garbage
喻|[yù] 比喻 bǐyù analogy; 隐喻 yǐnyù metaphor
框|[kuàng] frame; case; circle
繳|[jiǎo] hand in, pay<br /><br />[zhuó] silk string attached to an arrow for shooting birds
蹈|[dǎo] skip; step; 舞蹈 wǔdǎo dance
哨|[shào] whistle; chirp; sentry post
穎|[yǐng] 新颖 xīnyǐng new and original, novel
菊|[jú] chrysanthemum
喀|[kā] (sound of coughing or vomiting)
妝|[zhuāng] adorn oneself; 妆奁 bride's trousseau
淹|[yān] flood; 淹死 drown
瓷|[cí] porcelain, china; 陶瓷 táocí ceramics
淀|[diàn] shallow water; (F澱) form sediment; settle; precipitate; 淀粉 diànfěn starch
蠟|[là] wax, polish, yellowish, (=蜡烛 làzhú) candle
嚼|[jué] 咀嚼 jǔjué chew<br /><br />[jiáo] chew<br /><br />[jiào] 倒嚼
劑|[jì] dose
逛|[guàng] stroll, ramble, roam
驟|[zhòu] gallop; 步骤 bùzhòu procedure; 骤然 zhòurán suddenly
暑|[shǔ] hot weather; 暑假 (shǔjià) summer vacation
襟|[jīn] front of garment, bros. in law; 衣襟 yījīn front of Chinese jacket
廬|[lú] hut, cottage
蘋|[píng] 苹果 píngguǒ apple
曬|[shài] roast in sun
悼|[dào] 追悼, 悼念, 哀悼 mourn, grieve
昧|[mèi] no sun; dark; obscure; hidden; to feign
攏|[lǒng] approach; hold together; comb (hair)
函|[hán] letter; 函件 hánjiàn correspondence; 函数 fánshù (math) function
朧|[lóng] 朦胧 ménglóng dim moonlight; obscure<br /><br />[lōng]
膠|[jiāo] glue, gum, rubber, stick, sticky
抒|[shū] express, convey; 各抒己见
乒|[pīng] pīng on. crack (of rifle/etc.); 乒乓 pīngpāng pingpong<br /><br />{Compare with 兵 bīng soldier}
諷|[fěng] 讽刺 satirize, mock
歹|[dǎi] bad, evil, vicious
旱|[hàn] dry land; drought
葡|[pú] 葡萄 pútao grape; 葡萄酒 pútaojiǔ grape wine
惟|[wéi] only, alone, think, ponder, 惟一 wéiyī only, sole
揀|[jiǎn] choose, select, pick out
耿|[gěng] 耿耿 gěnggěng brilliant; dedicated; 耿直 gěngzhí upright
廿|[niàn] twenty (same as 二十 èrshí)
樁|[zhuāng] stake, pile; (量): 一桩大事
乙|[yǐ] 2nd in sequence
謠|[yáo] ballad; 谣言 yáoyán rumor, hearsay
墜|[zhuì] fall; weigh down; 坠子 zhuìzi weight; ear pendant; ballad
滯|[zhì] stagnant, sluggish
孕|[yùn] 怀孕 pregnant; 受孕 conceive; 避孕 contraception
誦|[sòng] 背诵 recite from memory
梳|[shū] (梳子) comb; to comb
岡|[gāng] ridge of a hill
肺|[fèi] (=肺脏 fèizàng) lung
丸|[wán] pill, pellet, ball
霜|[shuāng] (=霜冻 shuāngdòng) frost
汁|[zhī] (=汁液 zhīyè) juice; 果汁 guǒzhī fruit juice
紗|[shā] yarn; 绵纱 miánshā cotton yarn
銜|[xián] hold in mouth; hold inside; rank; 军衔 military rank
膩|[nì] greasy, oily; smooth; (腻烦 nìfan) disgusted, fed up
甸|[diàn] (ancient) suburb; pasture<br /><br />[diān] 沉甸甸 chéndiāndiān heavy
啤|[pí] 啤酒 píjiǔ beer
坎|[kǎn] bank, ridge
稼|[jià] to plant, (=庄稼 zhuāngjia) crops
禾|[hé] grain; 禾苗 hémiáo seedlings
愣|[lèng] distracted, stupified<br /><br />[lēng]
脂|[zhī] (=油脂 yóuzhī) oil, grease; 脂肪 zhīfáng fat, grease
萄|[táo] 葡萄 pútao grape
撈|[lāo] dredge for, fish for, scoop up out of water
攪|[jiǎo] disturb, annoy, (=搅拌) stir, mix, agitate,
屑|[xiè] fragments, bits and pieces; minute; trivial
傘|[sǎn] (雨伞) umbrella; 跳伞, 降落伞 parachute
蝶|[dié] 蝴蝶 húdié butterfly; 蝶蛹 diéyǒng chrysalis
鑄|[zhù] (铸造) casting, founding
軀|[qū] 身躯 body, stature; 躯体 body
稚|[zhì] young, immature, childish; 稚气 zhìqì childishness
腥|[xīng] flesh; fishy; 腥臭 xīngchòu rancid, stinking
藤|[téng] cane, rattan; vine
陡|[dǒu] steep; suddenly; 陡峭 dǒuqiào precipitous
燙|[tàng] hot (burning hot to the touch, cf. 热 rè)
梨|[lí] pear; 凤梨 pineapple
哦|[ó]<br /><br />[ò] Oh!<br /><br />[é] softly chant
漿|[jiāng] syrup, starch<br /><br />[jiàng] (=糨 jiàng) thick (of porridge etc.)
僻|[pì] 僻静 pìjìng secluded; 偏僻 piānpì out-of-the way
坊|[fāng] lane<br /><br />[fáng] workshop, mill
焉|[yān] 心不在焉 absent-minded
隙|[xì] gap; crack; rift; loophole
淘|[táo] wash, clean; 淘气 táoqì naughty; 淘汰 táotài eliminate
垮|[kuǎ] collapse, break down
滔|[tāo] 滔滔 tāotāo torrential; 滔滔不绝 talk on and on
釀|[niàng] brew, ferment, wine, (=酿成 niàngchéng) result in, breed
鵝|[é] goose; 企鹅 qǐ'é penguin
茲|[zī] {archaic}> this; now; year<br /><br />[cí] 龟兹
搗|[dǎo] pound, beat; harass; 捣乱 dǎoluàn make a disturbance
棟|[dòng] ridgepole
瑰|[guī]<br /><br />[gui] 玫瑰 méigui rose
敞|[chǎng] spacious; open
癌|[ái] (=癌症 áizhèng) cancer
纜|[lǎn] cable; 缆车 cable car
爍|[shuò] shining; 闪烁 glimmer, twinkle
玫|[méi] 玫瑰 méigui rose; 黄刺玫 yellow rose
詐|[zhà] cheat, swindle; pretend, feign
煞|[shà] evil spirit; 煞白 shàbái deathly pale<br /><br />[shā] stop, (= 刹 shā, =杀 shā) kill
膜|[mó] membrane, film; 角膜 jiǎomó cornea (of eye)
焚|[fén] (焚烧 fénshāo) burn, set on fire
粘|[zhān] to glue, to paste<br /><br />[nián] (=黏 nián) sticky
摧|[cuī] break, (=摧毁 cuīhuǐ, =摧残 cuīcán) destroy
疫|[yì] 免疫 miǎnyì immunity; 瘟疫 wēnyì pestilence
幢|[zhuàng] (量) (for buildings)<br /><br />[chuáng] pennant; Buddhist pillar
汝|[rǔ] you, thou
毯|[tǎn] (毯子 tǎnzi) blanket; (地毯 dìtǎn) carpet, rug
挫|[cuò] setback, (=挫折 cuòzhé) frustrate, defeat
紡|[fǎng] spin yarn; 纺织 fǎngzhī spin and weave; 纺车 fǎngchē spinning wheel
朽|[xiǔ] 腐朽 fǔxiǔ decayed, rotten
錘|[chuí] hammer
兌|[duì] exchange, convert, add (water etc.); 兑换 duìhuàn convert, exchange
辮|[biàn] braid
墮|[duò] fall, sink; 堕落 duòluò degenerate, sink low
笛|[dí] bamboo flute, whistle
覓|[mì] seek; look for; demand
蔽|[bì] cover, shelter, hide; 隐蔽 yǐnbì conceal oneself; covert
諧|[xié] in harmony
氓|[máng] 流氓 liúmáng hoodlum<br /><br />[méng] common people
蔑|[miè] 轻蔑 qīngmiè scornful
沸|[fèi] 沸腾 fèiténg boiling; 沸点 boiling point
藉|[jí] 狼藉 lángjí {archaic}> in disorder<br /><br />[jiè] (=借 jiè) borrow, lend
卸|[xiè] unload, discharge; remove; shirk
熄|[xī] extinguish, put out, go out; 熄灭 xīmiè go out, die out
扁|[biǎn] flat; inscription; 扁担 biǎndan carrying pole<br /><br />[piān] 扁舟
炭|[tàn] charcoal
慷|[kāng] high-spirited; 慷慨 kāngkǎi fervent; liberal, generous
篷|[péng] sail; 帐篷 zhàngpéng tent
眨|[zhǎ] wink, blink
譬|[pì] 譬如 pìrú for instance, for example
叨|[dāo] 叨叨 dāodao chatter<br /><br />[tāo] 叨光 tāoguāng much obliged
蔬|[shū] 蔬菜 shūcài vegetable
綢|[chóu] (丝绸 sīchóu) silk
婿|[xù] son-in-law
寥|[liáo] few, empty, vacant, lonely
澆|[jiāo] irrigate, water; pour liquid on; 浇花
乓|[pāng] bang; 乒乓 pīngpāng pingpong<br /><br />{Compare with 兵 bīng soldier}
膏|[gāo] 牙膏 yágāo toothpaste; 油膏 ointment<br /><br />[gào] lubricate
膛|[táng] (胸膛) chest; chamber
琢|[zuó] 琢磨 zuómo ponder<br /><br />[zhuó] 琢磨 zhuómó polish
啪|[pā] (sound:) bang
淑|[shū] {archaic}> kind and gentle
叭|[bā] (=吧) {used for sound value}>
弊|[bì] 弊病 bìbìng malady, evil; drawback; 利弊 pros and cons
灶|[zào] stove; kitchen
醋|[cù] vinegar; 吃醋 be jealous (in love affair)
斌|[bīn] (variant of 彬 bīn)
奠|[diàn] establish; give offerings to the dead
屯|[tún] (屯子) village; collect
膨|[péng] expand, inflate; 膨胀 péngzhàng expand, swell
淪|[lún] sink; 沦陷 lúnxiàn fall (to enemy); 沦为 be reduced to
縷|[lǚ] thread; strand; 蓝缕 lánlǚ shabby, ragged
壤|[rǎng] (=土壤 tǔrǎng) soil
冶|[yě] smelt (metal)
暇|[xiá] leisure; 空暇 kòngxiá spare time; 不暇 bùxiá be too busy
揉|[róu] rub, knead
蘿|[luó] vine; 萝卜 luóbo radish; 胡萝卜 húluóbo carrot; 菠萝 bōluó pineapple
翔|[xiáng] circle in the air
蛛|[zhū] 蜘蛛 zhīzhū spider
栗|[lì] (栗子 lìzi) chestnut; (F慄) tremble
蔭|[yìn] shady<br /><br />[yīn] (=阴)
譏|[jī] 讥笑 jīxiào mock; 讥讽 jīfěng ridicule
蔥|[cōng] green, (=葱头) onion, scallion
鞏|[gǒng] 巩固 gǒnggù consolidate
粥|[zhōu] porridge, gruel, congee<br /><br />[yù] (=鬻) sell, vend
齋|[zhāi] vegetarian religious diet, give alms, room or building
迄|[qì] 迄今 qìjīn hitherto, up to now, so far
幟|[zhì] 旗帜 qízhì banner, flag, stand, position
菌|[jūn] fungus, bacterium; 细菌, 病菌 germ<br /><br />[jùn] mushroom
鉛|[qiān] lead (Pb); 铅笔 qiānbǐ pencil
賄|[huì] (贿赂 huìlù) bribe; 行贿 give a bribe
絨|[róng] down; velvet; floss
侶|[lǚ] companion, associate
鍛|[duàn] forge; 锻炼 duànliàn exercise
譴|[qiǎn] 谴责 qiǎnzé condemn
洶|[xiōng] 汹涌 xiōngyǒng turbulent
敷|[fū] apply (powder, ointment, etc.); spread; 敷眼 to elaborate
宵|[xiāo] night; 通宵 tōngxiāo throughout the night; 元宵节 Yuánxiāojié Lantern Festival
諱|[huì] hide; avoid; name of deceased person
鑼|[luó] gong
撼|[hàn] 震撼 shake, shock, vibrate
亨|[hēng] successful, go smoothly, {electrical terminology}> henry
淌|[tǎng] drip (water or blood), shed (tears), trickle (sweat)
扛|[káng] carry on the shoulder<br /><br />[gāng] lift with both hands
杉|[shān] China fir<br /><br />[shā] 杉篙 shāgāo fir scaffold-pole
燥|[zào] dry; 干燥 gānzào dry, dull; 枯燥 kūzào boring
勻|[yún] to divide evenly; to spare; even
渺|[miǎo] 渺小 tiny, negligible; 渺茫 miǎománg distant and indistinct
碟|[dié] small plate or dish; 茶碟 saucer; 飞碟 frisbee, UFO
嵌|[qiàn] 镶嵌 xiāngqiàn inlay, set, mount
沃|[wò] irrigate; (肥沃 féiwò) fertile; 沃野 wòyě fertile land
剖|[pōu] cut/slit open, (=解剖 jiěpōu) dissect; 剖面 pōumiàn cross section, sectional view; 剖析 pōuxī analyse, dissect
姬|[jī] {archaic}> honorable woman, concubine, {family name}>
綽|[chuò] 绰号 chuòhào nickname<br /><br />[chāo] grab; take up
嗦|[suō] 哆嗦 duōsuo tremble, shiver
絞|[jiǎo] twist; 绞杀 strangle; 绞刑 death by hanging
軸|[zhóu] axle; axis; spool<br /><br />[zhòu]
壘|[lěi] build by piling up stones etc.; 垒求 softball
噪|[zào] 噪声 zàoshēng noise
蘊|[yùn] 蕴藏 yùncáng contain, hold in store
邵|[Shào] {family name}>
咋|[zǎ] {local}> (=怎么 zěnme) how<br /><br />[zé] {archaic}> bite<br /><br />[zhā] how?, what?, why?; 咋呼 zhāhu bluster, show off<br /><br />[zhà] bite; 咋舌 zhàshé cluck with the tongue (in surrprice/etc.), to be left speechless<br /><br />{Compare with 昨 zuó yesterday}
坪|[píng] level ground; 草坪 cǎopíng lawn
傭|[yōng] hire, (=佣人 yōngrén) servant; 雇佣 gùyōng hire<br /><br />[yòng] (=佣金 yòngjīn) commission
卵|[luǎn] (卵子) egg, ovum; 卵巢 luǎncháo ovary
晝|[zhòu] daytime
憋|[biē] check, restrain, suppress; suffocate, feel depressed
奎|[kuí] (used in transliterations) 奎宁 kuíníng quinine
捂|[wǔ] seal, cover, muffle<br /><br />[wú] 枝捂
煎|[jiān] to fry
瞅|[chǒu] see, look at<br /><br />[qiu] 溜瞅
蝕|[shí] lose; erode, corrode
熔|[róng] fuse, smelt, (熔化 rónghuà) melt; 熔岩 róngyán lava
蝦|[xiā] shrimp; 龙虾 lóngxiā lobster; 虾炒饭 xiāchǎofàn shrimp fried rice<br /><br />[há] (=蛤); 虾蟆 háma frog, toad
謬|[miù] 荒谬 huāngmiù absurd; 谬论 miùlùn fallacy
紳|[shēn] 绅士 shēnshì gentleman, gentry
鑲|[xiāng] inlay; edge
聾|[lóng] (耳聋 ěrlóng) deaf
募|[mù] raise, recruit
壟|[lǒng] ridge or raised path in field; 垄断 monopolize
彥|[yàn] man of virtue and ability
翹|[qiào] hold up; 翘尾巴 qiào wěiba "to hold up the tail" = to be/get cocky, to be snobbish and self-important<br /><br />[qiáo] raise one's head; become warped
趴|[pā] lie prone; lean over
杏|[xìng] apricot; 杏仁 almond
彰|[zhāng] obvious, apparant; showy; 表彰 biǎozhāng commend, cite
闡|[chǎn] 阐明 chǎnmíng clarify; 阐述 chǎnshù expound
訟|[sòng] 诉讼 sùsòng lawsuit
樞|[shū] 枢纽 shūniǔ pivot, axis
嶄|[zhǎn] {archaic}> towering; 崭新 zhǎnxīn brand-new, completely new
蒲|[pú] cattail, {family name}>
瀉|[xiè] 倾泻 come down in torrents; 泻药 laxative
儉|[jiǎn] economical, (=俭朴 jiǎnpǔ) frugal; 勤俭 qínjiǎn industrious and thrifty
橡|[xiàng] (=橡树 xiàngshù) oak, rubber tree; 橡胶 xiàngjiāo rubber; 橡皮 xiàngpí eraser, rubber
溶|[róng] (=溶化 rónghuà) dissolve; 溶液 (chemical) solution
瀑|[pù] 瀑布 pùbù waterfall
扒|[bā] hold on to; dig up; rake; strip<br /><br />[pá] rake up; stew, braise
琛|[chēn] {archaic}> treasure